%s says %s => JE: %s が、%s、と言いました / BE: %s の発言: %s
Tab => JE: Tab / BE: タブ
Edit World => JE: ワールドを編集 / BE: 世界を編集
Space => JE: Space / BE: SPACE キー
Acquire Hardware => JE: 金属を手に入れる / BE: メタルに決めろ
Smelt an iron ingot => JE: 鉄インゴットを製錬する / BE: 鉄の延べ棒を精錬しよう。
Relieve a Blaze of its rod => JE: ブレイズロッドを手に入れる / BE: ロッドからブレイズを解放しよう。
Construct a better pickaxe => JE: より良いツルハシをつくる / BE: より質の高いツルハシを作ろう。
Beaconator => JE: ビーコネーター / BE: ビーコン使い
Return to Sender => JE: 差出人に返送 / BE: 仕返し
Destroy a Ghast with a fireball => JE: 火の玉をガストに打ち返す / BE: 火の玉をガストに打ち返そう。
Monster Hunter => JE: モンスターハンター / BE: モンスター退治
Local Brewery => JE: 町のお薬屋さん / BE: 町の薬屋さん
Brew a potion => JE: ポーションを醸造する / BE: ポーションを調合しよう。
The End? => JE: おしまい？ / BE: 果ての世界?
??? => JE: ？？？ / BE: ???
Edit => JE: 編集 / BE: 編集する
Must be an opped player in creative mode => JE: オペレーター権限のあるクリエイティブモードのプレイヤーでなくてはなりません / BE: オペレーター権限のあるプレイヤーが、クリエイティブ モードの場合のみ可能です
Command blocks are not enabled on this server => JE: このサーバーではコマンドブロックが有効ではありません / BE: コマンド ブロックは、このサーバー上では有効になっていません
Set Console Command for Block => JE: コマンドブロックが実行するコンソールコマンド / BE: コマンドブロックのコンソールコマンドを設定
Command set: %s => JE: コマンドを設定しました：%s / BE: コマンドを設定しました: %s
Mob Follow Range => JE: Mobの追跡範囲 / BE: モブの追跡範囲
Speed => JE: 移動速度上昇 / BE: スピード
Horse Jump Strength => JE: ウマの跳躍力 / BE: 馬の跳躍力
Enter Book Title: => JE: 本のタイトルを入力してください： / BE: 本のタイトルを入力してください:
Note! When you sign the book, it will no longer be editable. => JE: 注意！署名をすると、二度と編集ができなくなります。 / BE: 注意! 署名をすると、二度と編集できなくなります!
Tattered => JE: ボロボロ / BE: すり減った
Page %1$s of %2$s => JE: %1$s／%2$sページ / BE: %1$s/%2$s ページ
Height limit for building is %s blocks => JE: 建築限界高度は%sブロックです / BE: 建築高度限界は %s ブロックです
Locked => JE: ロックされています / BE: ロック中
Unlocked => JE: 解除しました / BE: ロック解除中
Cannot send chat message => JE: チャットメッセージを送信できません / BE: チャット メッセージを送信できません
Copy to Clipboard => JE: コピー / BE: クリップボードにコピー
Are you sure you want to open the following website? => JE: このウェブサイトを開きますか？ / BE: 本当にこのウェブサイトを開きますか?
Do you want to open this link or copy it to your clipboard? => JE: このリンクをブラウザで開きますか？それともクリップボードにコピーしますか？ / BE: このリンクをブラウザで開きますか? それともクリップボードにコピーしますか?
Never open links from people that you don't trust! => JE: 信頼できないリンクは絶対に開かないでください / BE: 信頼していない人からのリンクは絶対に開かないで下さい!
Line Spacing => JE: 行間 / BE: 行の間隔
Large Chest => JE: ラージチェスト / BE: 大きなチェスト
Inventory => JE: インベントリ / BE: 持ち物
Black => JE: 黒色 / BE: 黒
Blue => JE: 青色 / BE: 青
Green => JE: 緑色 / BE: 緑
Red => JE: 赤色 / BE: 赤
White => JE: 白色 / BE: 白
Impulse => JE: インパルス / BE: 衝撃
Repeat => JE: リピート / BE: 反復
Needs Redstone => JE: 動力が必要 / BE: レッドストーンが必要
Always Active => JE: 常時実行 / BE: 常にアクティブ
There are no custom bossbars active => JE: アクティブなカスタムボスバーがありません / BE: 有効なカスタム ボスバーはありません
Block placed => JE: ブロックが置かれる / BE: ブロックを設置しました
Stopping the server => JE: サーバーを停止します / BE: サーバーを停止しています
Target either already has the tag or has too many tags => JE: 対象は既にそのタグを持っているか、これ以上タグを追加できません / BE: ターゲットに既に指定のタグがあるか、タグが多すぎます
Target does not have this tag => JE: 対象はそのタグを持っていません / BE: ターゲットにはこのタグがありません
Logging in... => JE: ログイン中… / BE: ログイン中...
Connecting to the server... => JE: サーバーに接続中… / BE: サーバーに接続中...
Brewing Stand => JE: 醸造台 / BE: 調合台
Dispenser => JE: ディスペンサー / BE: 発射装置
%s . . . ? => JE: %s . . .？ / BE: %s . . . ?
1 Lapis Lazuli => JE: ラピスラズリ1個 / BE: ラピスラズリ 1個
1 Enchantment Level => JE: 1エンチャントレベル / BE: 1 エンチャントレベル
Ender Chest => JE: エンダーチェスト / BE: エンダー チェスト
Item Hopper => JE: ホッパー / BE: アイテム ホッパー
%s is locked! => JE: %sはロックされています / BE: %s はロックされている!
Loom => JE: 機織り機 / BE: 織機
Repair & Name => JE: 修繕・名付け / BE: 修理 & 名づけ
Too Expensive! => JE: コストが高すぎます！ / BE: コストが高すぎます!
Repair & Disenchant => JE: 修繕・エンチャント除去 / BE: 修理とエンチャント解除
Stonecutter => JE: 石切台 / BE: ストーン カッター
Upgrade Gear => JE: 装備の強化 / BE: 装備をアップグレードする
Shulker Box => JE: シュルカーボックス / BE: シュルカー ボックス
Barrel => JE: 樽 / BE: タル
Save => JE: セーブ / BE: 保存
Reset Keys => JE: 操作設定をリセット / BE: キー設定のリセット
Controls => JE: 操作設定 / BE: 操作方法
Depth Base Size => JE: 深度基本量 / BE: 奥行きベースサイズ
Biome Depth Offset => JE: バイオーム深度偏差 / BE: バイオームの奥行きの偏り
Biome Depth Weight => JE: バイオーム深度比重 / BE: バイオームの奥行きのウェイト
Biome Scale Offset => JE: バイオーム規模偏差 / BE: バイオームスケールの偏り
Biome Scale Weight => JE: バイオーム規模比重 / BE: バイオームスケールのウェイト
Biome Size => JE: バイオームの大きさ / BE: バイオームのサイズ
Center Height => JE: 中心高度 / BE: 中心の高さ
This will overwrite your current => JE: 現在の設定を上書きします。 / BE: 現在の設定を上書きしてます
settings and cannot be undone. => JE: 元に戻すことはできません。 / BE: 設定の復元はできません。
Warning! => JE: 警告 / BE: 警告!
Coordinate Scale => JE: 座標尺 / BE: スケール調整
Spawn Tries => JE: 生成頻度 / BE: スポーンさせてみる
Defaults => JE: デフォルトに戻す / BE: デフォルト
Depth Noise Exponent => JE: 深度ノイズ指数 / BE: 奥行きノイズ指数
Depth Noise Scale X => JE: 深度ノイズ規模 X / BE: 奥行きノイズスケール X
Depth Noise Scale Z => JE: 深度ノイズ規模 Z / BE: 奥行きノイズスケール Z
Dungeon Count => JE: ダンジョンの数 / BE: ダンジョン合計数
Height Scale => JE: 高度規模 / BE: 高さスケール
Lava Lake Rarity => JE: 溶岩湖の希少度 / BE: 溶岩湖の出現率
Lower Limit Scale => JE: 規模下限 / BE: スケール下限
Main Noise Scale X => JE: 主要ノイズ規模 X / BE: メインノイズスケール X
Main Noise Scale Y => JE: 主要ノイズ規模 Y / BE: メインノイズスケール Y
Main Noise Scale Z => JE: 主要ノイズ規模 Z / BE: メインノイズスケール Z
Max. Height => JE: 高度上限 / BE: 高さ上限
Min. Height => JE: 高度下限 / BE: 高さ下限
Next Page => JE: 次のページへ / BE: 次へ
Advanced Settings (Expert Users Only!) => JE: 高度な設定（上級者向け） / BE: 高度な設定 (上級ユーザーのみ!)
Extra Advanced Settings (Expert Users Only!) => JE: さらに高度な設定（上級者向け） / BE: その他の高度な設定 (上級ユーザーのみ!)
Good Luck => JE: 幸運を祈る / BE: グッドラック
Water World => JE: 水の世界 / BE: 水世界
Customize World Presets => JE: カスタマイズワールドのプリセット / BE: 世界プリセットをカスタマイズする
Previous Page => JE: 前のページへ / BE: 前へ
Randomize => JE: ランダム化 / BE: ランダマイズ
River Size => JE: 川の大きさ / BE: 川のサイズ
Sea Level => JE: 海面高度 / BE: 海面の高さ
Spawn Size => JE: 最大生成数 / BE: スポーン サイズ
Spread Height => JE: 分散高度 / BE: 出現高度
Height Stretch => JE: 高度伸長 / BE: 高さ伸び
Upper Limit Scale => JE: 規模上限 / BE: スケール上限
Lava Lakes => JE: 溶岩湖 / BE: マグマ溜まり
Lava Oceans => JE: 溶岩の海 / BE: マグマの海
Ocean Monuments => JE: 海底神殿 / BE: 海底遺跡
Ravines => JE: 峡谷 / BE: 渓谷
Temples => JE: 寺院 / BE: ジャングルの寺院
Water Lake Rarity => JE: 池の希少度 / BE: 池の出現率
Remove Layer => JE: 地層を削除 / BE: レイヤーを削除
Layer Material => JE: 地層の構成物 / BE: レイヤーの構成物
Alternatively, here's some we made earlier! => JE: もしくは、次のプリセットから選べます / BE: もしくは、次のプリセットから選んでください!
Select a Preset => JE: プリセットの選択 / BE: プリセットを選択
New World => JE: 新規ワールド / BE: 新たな世界
Bonus Chest => JE: ボーナスチェスト / BE: ボーナス チェスト
Delete => JE: Delete / BE: 削除
Adventure => JE: 冒険 / BE: アドベンチャー
World Type => JE: ワールドタイプ / BE: 世界のタイプ
%s chunks => JE: %sチャンク / BE: %s チャンク
Blocked => JE: ブロック中 / BE: ブロック済み
Join Server => JE: サーバーに接続 / BE: サーバーに参加
World => JE: ワールド / BE: 世界
%s %s => JE: %2$s %1$s / BE: %s %s
Search... => JE: 検索… / BE: 検索中...
%1$s was squashed by a falling anvil => JE: %1$sは落下してきた金床に押しつぶされた / BE: %1$s は落下した金床に潰された
%1$s was shot by %2$s => JE: %1$sは%2$sに射抜かれた / BE: %1$s は %2$s に射抜かれた
%1$s was shot by %2$s using %3$s => JE: %1$sは%2$sの%3$sで射抜かれた / BE: %1$s は %2$s の %3$s で射抜かれた
%1$s was pricked to death => JE: %1$sはサボテンが刺さって死んだ / BE: %1$s は刺されて力尽きた
%1$s walked into a cactus whilst trying to escape %2$s => JE: %1$sは%2$sから逃げようとしてサボテンにぶつかった / BE: %1$s は %2$s から逃げようとするうちにサボテンに足を踏み入れた
%1$s drowned => JE: %1$sは溺れ死んだ / BE: %1$s は溺れて力尽きた
%1$s drowned whilst trying to escape %2$s => JE: %1$sは%2$sから逃れようとして溺れ死んだ / BE: %1$s は %2$s から逃れようとするうちに溺れてしまった
%1$s blew up => JE: %1$sは爆発に巻き込まれた / BE: %1$s は爆発した
%1$s was blown up by %2$s => JE: %1$sは%2$sに爆破された / BE: %1$s は %2$s に吹き飛ばされた
%1$s hit the ground too hard => JE: %1$sは地面に強く激突した / BE: %1$s は落下の衝撃で力尽きた
%1$s was squashed by a falling block => JE: %1$sは落下してきたブロックに押しつぶされた / BE: %1$s は落下したブロックに潰された
%1$s was fireballed by %2$s => JE: %1$sは%2$sに火だるまにされた / BE: %1$s は %2$s に火だるまにされた
%1$s was fireballed by %2$s using %3$s => JE: %1$sは%2$sの%3$sで火だるまにされた / BE: %1$s は %2$s の %3$s で火だるまにされた
%1$s went off with a bang => JE: %1$sは花火の爆発に巻き込まれた / BE: %1$s は大成功しました
%1$s experienced kinetic energy => JE: %1$sは運動エネルギーを体験した / BE: %1$s は身をもって運動エネルギーを感じた
%1$s died => JE: %1$sは死んだ / BE: %1$s は力尽きた
%1$s was killed by %2$s using magic => JE: %1$sは%2$sの魔法で殺された / BE: %1$s は %2$s の魔法により力尽きた
%1$s was killed by %2$s using %3$s => JE: %1$sは%2$sの%3$sで殺された / BE: %1$s は %2$s の %3$s により力尽きた
%1$s went up in flames => JE: %1$sは炎に巻かれた / BE: %1$s は火の中で力尽きた
%1$s walked into fire whilst fighting %2$s => JE: %1$sは%2$sと戦いながら火の中へ踏み入った / BE: %1$s は %2$s と戦ううちに火の中へ歩いて行った
%1$s suffocated in a wall => JE: %1$sは壁の中で窒息した / BE: %1$s は壁に飲み込まれた
%1$s tried to swim in lava => JE: %1$sは溶岩遊泳を試みた / BE: %1$s は溶岩に飲み込まれた
%1$s tried to swim in lava to escape %2$s => JE: %1$sは%2$sから逃れようと溶岩遊泳を試みた / BE: %1$s は %2$s から逃れるために溶岩の中を泳ごうとした
%1$s was struck by lightning => JE: %1$sは雷に打たれた / BE: %1$s は雷に打たれた
%1$s was killed by magic => JE: %1$sは魔法で殺された / BE: %1$s は魔法により力尽きた
%1$s was slain by %2$s => JE: %1$sは%2$sに殺害された / BE: %1$sは%2$sに倒された
%1$s burned to death => JE: %1$sはこんがりと焼けた / BE: %1$s は火によって力尽きた
%1$s was burnt to a crisp whilst fighting %2$s => JE: %1$sは%2$sと戦いながらカリカリに焼けた / BE: %1$s は %2$s と戦ううちにカリカリに焼かれた
%1$s fell out of the world => JE: %1$sは奈落の底へ落ちた / BE: %1$s は世界の外へ落ちた
%1$s was slain by %2$s using %3$s => JE: %1$sは%2$sの%3$sで殺害された / BE: %1$s は %2$s の %3$s により倒された
%1$s starved to death => JE: %1$sは飢え死にした / BE: %1$s は飢えて力尽きた
%1$s was killed trying to hurt %2$s => JE: %1$sは%2$sを傷つけようとして殺された / BE: %2$s に損害を与えようとした %1$s が倒された
%1$s was pummeled by %2$s => JE: %1$sは%2$sによってぺしゃんこにされた / BE: %1$s は %2$s に叩き潰された
%1$s was pummeled by %2$s using %3$s => JE: %1$sは%2$sの%3$sでぺしゃんこにされた / BE: %1$s は %2$s に %3$s で打倒された
%1$s withered away => JE: %1$sは干からびた / BE: %1$s は弱り果てた
%1$s fell from a high place => JE: %1$sは高い所から落ちた / BE: %1$s は高い所から落ちた
%1$s fell off a ladder => JE: %1$sははしごから落ちた / BE: %1$s ははしごから落ちた
%1$s fell off some vines => JE: %1$sはツタから滑り落ちた / BE: %1$s は、つるから落ちた
%1$s was doomed to fall by %2$s => JE: %1$sは%2$sに落とされる運命だった / BE: %1$s は %2$s によって滅びる運命にあった
%1$s was doomed to fall by %2$s using %3$s => JE: %1$sは%2$sの%3$sで落とされる運命だった / BE: %1$s は %2$s の使う %3$s によって滅びる運命にあった
%1$s fell too far and was finished by %2$s => JE: %1$sは高いところから落下し、%2$sによってとどめを刺された / BE: %1$s はあまりに高いところから落ち、%2$s にとどめを刺された
%1$s fell too far and was finished by %2$s using %3$s => JE: %1$sは高いところから落下し、%2$sの%3$sによってとどめを刺された / BE: %1$s はあまりに高いところから落ち、%2$s に %3$s を使ってとどめを刺された
%1$s was doomed to fall => JE: %1$sは落ちる運命だった / BE: %1$s は滅びる運命にあった
Are you sure you want to quit? => JE: 終了しますか？ / BE: 終了してもよろしいですか?
Day Two => JE: 2日目 / BE: 2 日目
Day Three => JE: 3日目 / BE: 3 日目
Day Four => JE: 4日目 / BE: 4 日目
This is your last day! => JE: 今日が最終日です！ / BE: 今日が最終日です!
Your time is almost up! => JE: もうすぐ時間切れです！ / BE: もうすぐ時間切れです!
Demo time's up! => JE: 時間切れです！ / BE: 時間切れです!
Purchase Now! => JE: 今すぐ購入！ / BE: 今すぐ購入!
Continue Playing! => JE: プレイを続行！ / BE: プレイを続ける!
Minecraft Demo Mode => JE: Minecraftデモ版 / BE: Mnecraft デモ版
Remaining time: %s => JE: 残り時間：%s / BE: 残り時間: %s
Are you sure you want to lock the difficulty of this world? This will set this world to always be %1$s, and you will never be able to change that again. => JE: このワールドの難易度を固定しますか？ 設定後、このワールドの難易度は常に%1$sになり、以後再び変更することはできなくなります。 / BE: この世界の難易度を固定しますか? 設定後、この世界の難易度は常に %1$s になり、以後再び変更する事は出来なくなります。
Lock World Difficulty => JE: ワールドの難易度の固定 / BE: 世界の難易度の固定
Disconnected by Server => JE: サーバーから切断されました / BE: サーバーにより切断されました
End of stream => JE: 接続が終了されました / BE: ストリーミングが終了しました
Connection Lost => JE: 接続を維持できません / BE: 接続が切断されました
Quitting => JE: 終了中 / BE: 終了しています
Kicked for spamming => JE: スパム行為のために退出させられました / BE: スパム行為のために追放されました
Bad Omen => JE: 不吉な予感 / BE: 凶兆
Power => JE: 射撃ダメージ増加 / BE: パワー
Flame => JE: フレイム / BE: 火炎
Punch => JE: パンチ / BE: 衝撃
Multishot => JE: 拡散 / BE: マルチショット
Quick Charge => JE: 高速装填 / BE: クイック チャージ
Sharpness => JE: ダメージ増加 / BE: 鋭さ
Bane of Arthropods => JE: 虫特効 / BE: 虫殺し
Smite => JE: アンデッド特効 / BE: 聖なる力
Efficiency => JE: 効率強化 / BE: 効率
Frost Walker => JE: 氷渡り / BE: 氷上歩行
VII => JE: VII / BE: Ⅶ
VIII => JE: VIII / BE: Ⅷ
IX => JE: IX / BE: Ⅸ
Looting => JE: ドロップ増加 / BE: アイテムボーナス
Protection => JE: ダメージ軽減 / BE: 防護
Feather Falling => JE: 落下耐性 / BE: 落下軽減
Fire Protection => JE: 火炎耐性 / BE: 防火
Projectile Protection => JE: 飛び道具耐性 / BE: 間接攻撃耐性
Soul Speed => JE: ソウルスピード / BE: 魂の速度
Thorns => JE: 棘の鎧 / BE: とげ
Depth Strider => JE: 水中歩行 / BE: 水中移動
Aqua Affinity => JE: 水中採掘 / BE: 水中作業
Channeling => JE: 召雷 / BE: チャネリング
Loyalty => JE: 忠誠 / BE: 忠誠心
Impaling => JE: 水生特効 / BE: 串刺し
Area Effect Cloud => JE: エリアエフェクトクラウド / BE: 範囲効果の雲
Bee => JE: ミツバチ / BE: ハチ
Cow => JE: ウシ / BE: 牛
Drowned => JE: ドラウンド / BE: 溺死ゾンビ
Egg => JE: 卵 / BE: タマゴ
Elder Guardian => JE: エルダーガーディアン / BE: エルダー ガーディアン
Ender Dragon => JE: エンダードラゴン / BE: エンダー ドラゴン
Salmon => JE: サケ / BE: 鮭
Piglin Brute => JE: ピグリンブルート / BE: Piglin ブルート
Hoglin => JE: ホグリン / BE: Hoglin
Horse => JE: ウマ / BE: 馬
Iron Golem => JE: アイアンゴーレム / BE: アイアン ゴーレム
Leash Knot => JE: リードの結び目 / BE: 首ひもの結び目
Lightning Bolt => JE: 雷 / BE: 雷雨
Magma Cube => JE: マグマキューブ / BE: マグマ キューブ
Minecart with TNT => JE: TNT付きトロッコ / BE: TNT 火薬付きトロッコ
Painting => JE: 絵画 / BE: 絵
Pig => JE: ブタ / BE: 豚
Piglin => JE: ピグリン / BE: Piglin
Pillager => JE: ピリジャー / BE: 略奪者
Polar Bear => JE: シロクマ / BE: ホッキョクグマ
Sheep => JE: ヒツジ / BE: 羊
Skeleton Horse => JE: スケルトンホース / BE: スケルトン ホース
Snow Golem => JE: スノウゴーレム / BE: スノー ゴーレム
Turtle => JE: カメ / BE: 亀
Cleric => JE: 聖職者 / BE: 司祭
Fisherman => JE: 釣り人 / BE: 漁師
Leatherworker => JE: 革細工師 / BE: 革職人
Wither => JE: 衰弱 / BE: ウィザー
Wither Skeleton => JE: ウィザースケルトン / BE: ウィザー スケルトン
Wither Skull => JE: ウィザーの頭蓋骨 / BE: ウィザーの頭
Bottle o' Enchanting => JE: エンチャントの瓶 / BE: エンチャントのビン
Zombie Horse => JE: ゾンビホース / BE: ゾンビ馬
Zombified Piglin => JE: ゾンビピグリン / BE: ゾンビ化 Piglin
Server Address => JE: サーバーアドレス / BE: サーバー アドレス
Are you sure you want to remove this server? => JE: このサーバーを削除しますか？ / BE: 本当にこのサーバーを削除しますか?
Adventure Mode => JE: アドベンチャーモード / BE: アドベンチャー モード
Your game mode has been updated to %s => JE: ゲームモードが%sに変更されました / BE: ゲーム モードを %s に更新しました
Creative Mode => JE: クリエイティブモード / BE: クリエイティブ モード
Hardcore Mode! => JE: ハードコアモード / BE: ハードコアモード!
Survival Mode => JE: サバイバルモード / BE: サバイバル モード
Debug Mode => JE: デバッグモード / BE: デバッグ モード
Old => JE: 古いです / BE: 古い
Resource Packs... => JE: リソースパック… / BE: リソース パック...
Enchanting Table => JE: エンチャントテーブル / BE: エンチャント テーブル
Multiplayer => JE: マルチプレイ / BE: マルチプレイヤー
Transportation => JE: 運送 / BE: 移動手段
Destroy Item => JE: アイテムを削除 / BE: アイテム削除
Tipped Arrow => JE: 効能付きの矢 / BE: 効能付き矢
Black Banner => JE: 黒色の旗 / BE: 黒の旗
Blue Banner => JE: 青色の旗 / BE: 青の旗
Black Bordure => JE: 黒色の縁取り / BE: 黒の縁
Blue Bordure => JE: 青色の縁取り / BE: 青の縁
Brown Bordure => JE: 茶色の縁取り / BE: 茶色の縁
Cyan Bordure => JE: 青緑色の縁取り / BE: 水色の縁
Gray Bordure => JE: 灰色の縁取り / BE: 灰色の縁
Green Bordure => JE: 緑色の縁取り / BE: 緑の縁
Light Blue Bordure => JE: 空色の縁取り / BE: 空色の縁
Lime Bordure => JE: 黄緑色の縁取り / BE: 黄緑の縁
Magenta Bordure => JE: 赤紫色の縁取り / BE: 赤紫の縁
Orange Bordure => JE: 橙色の縁取り / BE: オレンジの縁
Pink Bordure => JE: 桃色の縁取り / BE: ピンクの縁
Purple Bordure => JE: 紫色の縁取り / BE: 紫の縁
Red Bordure => JE: 赤色の縁取り / BE: 赤の縁
Light Gray Bordure => JE: 薄灰色の縁取り / BE: 薄灰色の縁
White Bordure => JE: 白色の縁取り / BE: 白の縁
Yellow Bordure => JE: 黄色の縁取り / BE: 黄色の縁
Black Field Masoned => JE: 黒色のレンガ模様 / BE: 黒のレンガ模様
Blue Field Masoned => JE: 青色のレンガ模様 / BE: 青のレンガ模様
Cyan Field Masoned => JE: 青緑色のレンガ模様 / BE: 水色のレンガ模様
Green Field Masoned => JE: 緑色のレンガ模様 / BE: 緑のレンガ模様
Lime Field Masoned => JE: 黄緑色のレンガ模様 / BE: 黄緑のレンガ模様
Magenta Field Masoned => JE: 赤紫色のレンガ模様 / BE: 赤紫のレンガ模様
Orange Field Masoned => JE: 橙色のレンガ模様 / BE: オレンジのレンガ模様
Pink Field Masoned => JE: 桃色のレンガ模様 / BE: ピンクのレンガ模様
Purple Field Masoned => JE: 紫色のレンガ模様 / BE: 紫のレンガ模様
Red Field Masoned => JE: 赤色のレンガ模様 / BE: 赤のレンガ模様
White Field Masoned => JE: 白色のレンガ模様 / BE: 白のレンガ模様
Black Roundel => JE: 黒色の円形 / BE: 黒の円
Blue Roundel => JE: 青色の円形 / BE: 青の円
Brown Roundel => JE: 茶色の円形 / BE: 茶色の円
Cyan Roundel => JE: 青緑色の円形 / BE: 水色の円
Gray Roundel => JE: 灰色の円形 / BE: 灰色の円
Green Roundel => JE: 緑色の円形 / BE: 緑の円
Light Blue Roundel => JE: 空色の円形 / BE: 空色の円
Lime Roundel => JE: 黄緑色の円形 / BE: 黄緑の円
Magenta Roundel => JE: 赤紫色の円形 / BE: 赤紫の円
Orange Roundel => JE: 橙色の円形 / BE: オレンジの円
Pink Roundel => JE: 桃色の円形 / BE: ピンクの円
Purple Roundel => JE: 紫色の円形 / BE: 紫の円
Red Roundel => JE: 赤色の円形 / BE: 赤の円
Light Gray Roundel => JE: 薄灰色の円形 / BE: 薄灰色の円
White Roundel => JE: 白色の円形 / BE: 白の円
Yellow Roundel => JE: 黄色の円形 / BE: 黄色の円
Black Creeper Charge => JE: 黒色のクリーパー模様 / BE: 黒のクリーパー模様
Blue Creeper Charge => JE: 青色のクリーパー模様 / BE: 青のクリーパー模様
Cyan Creeper Charge => JE: 青緑色のクリーパー模様 / BE: 水色のクリーパー模様
Green Creeper Charge => JE: 緑色のクリーパー模様 / BE: 緑のクリーパー模様
Lime Creeper Charge => JE: 黄緑色のクリーパー模様 / BE: 黄緑のクリーパー模様
Magenta Creeper Charge => JE: 赤紫色のクリーパー模様 / BE: 赤紫のクリーパー模様
Orange Creeper Charge => JE: 橙色のクリーパー模様 / BE: オレンジのクリーパー模様
Pink Creeper Charge => JE: 桃色のクリーパー模様 / BE: ピンクのクリーパー模様
Purple Creeper Charge => JE: 紫色のクリーパー模様 / BE: 紫のクリーパー模様
Red Creeper Charge => JE: 赤色のクリーパー模様 / BE: 赤のクリーパー模様
White Creeper Charge => JE: 白色のクリーパー模様 / BE: 白のクリーパー模様
Black Saltire => JE: 黒色の斜め十字 / BE: 黒の斜め十字
Blue Saltire => JE: 青色の斜め十字 / BE: 青の斜め十字
Cyan Saltire => JE: 青緑色の斜め十字 / BE: 水色の斜め十字
Green Saltire => JE: 緑色の斜め十字 / BE: 緑の斜め十字
Lime Saltire => JE: 黄緑色の斜め十字 / BE: 黄緑の斜め十字
Magenta Saltire => JE: 赤紫色の斜め十字 / BE: 赤紫の斜め十字
Orange Saltire => JE: 橙色の斜め十字 / BE: オレンジの斜め十字
Pink Saltire => JE: 桃色の斜め十字 / BE: ピンクの斜め十字
Purple Saltire => JE: 紫色の斜め十字 / BE: 紫の斜め十字
Red Saltire => JE: 赤色の斜め十字 / BE: 赤の斜め十字
White Saltire => JE: 白色の斜め十字 / BE: 白の斜め十字
Black Bordure Indented => JE: 黒色の波形の縁取り / BE: 黒のギザギザな縁
Blue Bordure Indented => JE: 青色の波形の縁取り / BE: 青のギザギザな縁
Brown Bordure Indented => JE: 茶色の波形の縁取り / BE: 茶色のギザギザな縁
Cyan Bordure Indented => JE: 青緑色の波形の縁取り / BE: 水色のギザギザな縁
Gray Bordure Indented => JE: 灰色の波形の縁取り / BE: 灰色のギザギザな縁
Green Bordure Indented => JE: 緑色の波形の縁取り / BE: 緑のギザギザな縁
Light Blue Bordure Indented => JE: 空色の波形の縁取り / BE: 空色のギザギザな縁
Lime Bordure Indented => JE: 黄緑色の波形の縁取り / BE: 黄緑のギザギザな縁
Magenta Bordure Indented => JE: 赤紫色の波形の縁取り / BE: 赤紫のギザギザな縁
Orange Bordure Indented => JE: 橙色の波形の縁取り / BE: オレンジのギザギザな縁
Pink Bordure Indented => JE: 桃色の波形の縁取り / BE: ピンクのギザギザな縁
Purple Bordure Indented => JE: 紫色の波形の縁取り / BE: 紫のギザギザな縁
Red Bordure Indented => JE: 赤色の波形の縁取り / BE: 赤のギザギザな縁
Light Gray Bordure Indented => JE: 薄灰色の波形の縁取り / BE: 薄灰色のギザギザな縁
White Bordure Indented => JE: 白色の波形の縁取り / BE: 白のギザギザな縁
Yellow Bordure Indented => JE: 黄色の波形の縁取り / BE: 黄色のギザギザな縁
Cyan Banner => JE: 青緑色の旗 / BE: 水色の旗
Black Per Bend Sinister => JE: 上に黒色の逆斜め分割 / BE: 黒の左上塗りつぶし
Blue Per Bend Sinister => JE: 上に青色の逆斜め分割 / BE: 青の左上塗りつぶし
Brown Per Bend Sinister => JE: 上に茶色の逆斜め分割 / BE: 茶色の左上塗りつぶし
Cyan Per Bend Sinister => JE: 上に青緑色の逆斜め分割 / BE: 水色の左上塗りつぶし
Gray Per Bend Sinister => JE: 上に灰色の逆斜め分割 / BE: 灰色の左上塗りつぶし
Green Per Bend Sinister => JE: 上に緑色の逆斜め分割 / BE: 緑の左上塗りつぶし
Light Blue Per Bend Sinister => JE: 上に空色の逆斜め分割 / BE: 空色の左上塗りつぶし
Lime Per Bend Sinister => JE: 上に黄緑色の逆斜め分割 / BE: 黄緑の左上塗りつぶし
Magenta Per Bend Sinister => JE: 上に赤紫色の逆斜め分割 / BE: 赤紫の左上塗りつぶし
Orange Per Bend Sinister => JE: 上に橙色の逆斜め分割 / BE: オレンジの左上塗りつぶし
Pink Per Bend Sinister => JE: 上に桃色の逆斜め分割 / BE: ピンクの左上塗りつぶし
Purple Per Bend Sinister => JE: 上に紫色の逆斜め分割 / BE: 紫の左上塗りつぶし
Red Per Bend Sinister => JE: 上に赤色の逆斜め分割 / BE: 赤の左上塗りつぶし
Light Gray Per Bend Sinister => JE: 上に薄灰色の逆斜め分割 / BE: 薄灰色の左上塗りつぶし
White Per Bend Sinister => JE: 上に白色の逆斜め分割 / BE: 白の左上塗りつぶし
Yellow Per Bend Sinister => JE: 上に黄色の逆斜め分割 / BE: 黄色の左上塗りつぶし
Black Per Bend => JE: 上に黒色の斜め分割 / BE: 黒の右上塗りつぶし
Blue Per Bend => JE: 上に青色の斜め分割 / BE: 青の右上塗りつぶし
Brown Per Bend => JE: 上に茶色の斜め分割 / BE: 茶色の右上塗りつぶし
Cyan Per Bend => JE: 上に青緑色の斜め分割 / BE: 水色の右上塗りつぶし
Gray Per Bend => JE: 上に灰色の斜め分割 / BE: 灰色の右上塗りつぶし
Green Per Bend => JE: 上に緑色の斜め分割 / BE: 緑の右上塗りつぶし
Light Blue Per Bend => JE: 上に空色の斜め分割 / BE: 空色の右上塗りつぶし
Lime Per Bend => JE: 上に黄緑色の斜め分割 / BE: 黄緑の右上塗りつぶし
Magenta Per Bend => JE: 上に赤紫色の斜め分割 / BE: 赤紫の右上塗りつぶし
Orange Per Bend => JE: 上に橙色の斜め分割 / BE: オレンジの右上塗りつぶし
Pink Per Bend => JE: 上に桃色の斜め分割 / BE: ピンクの右上塗りつぶし
Purple Per Bend => JE: 上に紫色の斜め分割 / BE: 紫の右上塗りつぶし
Red Per Bend => JE: 上に赤色の斜め分割 / BE: 赤の右上塗りつぶし
Light Gray Per Bend => JE: 上に薄灰色の斜め分割 / BE: 薄灰色の右上塗りつぶし
White Per Bend => JE: 上に白色の斜め分割 / BE: 白の右上塗りつぶし
Yellow Per Bend => JE: 上に黄色の斜め分割 / BE: 黄色の右上塗りつぶし
Black Per Bend Inverted => JE: 下に黒色の斜め分割 / BE: 黒の左下塗りつぶし
Blue Per Bend Inverted => JE: 下に青色の斜め分割 / BE: 青の左下塗りつぶし
Brown Per Bend Inverted => JE: 下に茶色の斜め分割 / BE: 茶色の左下塗りつぶし
Cyan Per Bend Inverted => JE: 下に青緑色の斜め分割 / BE: 水色の左下塗りつぶし
Gray Per Bend Inverted => JE: 下に灰色の斜め分割 / BE: 灰色の左下塗りつぶし
Green Per Bend Inverted => JE: 下に緑色の斜め分割 / BE: 緑の左下塗りつぶし
Light Blue Per Bend Inverted => JE: 下に空色の斜め分割 / BE: 空色の左下塗りつぶし
Lime Per Bend Inverted => JE: 下に黄緑色の斜め分割 / BE: 黄緑の左下塗りつぶし
Magenta Per Bend Inverted => JE: 下に赤紫色の斜め分割 / BE: 赤紫の左下塗りつぶし
Orange Per Bend Inverted => JE: 下に橙色の斜め分割 / BE: オレンジの左下塗りつぶし
Pink Per Bend Inverted => JE: 下に桃色の斜め分割 / BE: ピンクの左下塗りつぶし
Purple Per Bend Inverted => JE: 下に紫色の斜め分割 / BE: 紫の左下塗りつぶし
Red Per Bend Inverted => JE: 下に赤色の斜め分割 / BE: 赤の左下塗りつぶし
Light Gray Per Bend Inverted => JE: 下に薄灰色の斜め分割 / BE: 薄灰色の左下塗りつぶし
White Per Bend Inverted => JE: 下に白色の斜め分割 / BE: 白の左下塗りつぶし
Yellow Per Bend Inverted => JE: 下に黄色の斜め分割 / BE: 黄色の左下塗りつぶし
Black Per Bend Sinister Inverted => JE: 下に黒色の逆斜め分割 / BE: 黒の右下塗りつぶし
Blue Per Bend Sinister Inverted => JE: 下に青色の逆斜め分割 / BE: 青の右下塗りつぶし
Brown Per Bend Sinister Inverted => JE: 下に茶色の逆斜め分割 / BE: 茶色の右下塗りつぶし
Cyan Per Bend Sinister Inverted => JE: 下に青緑色の逆斜め分割 / BE: 水色の右下塗りつぶし
Gray Per Bend Sinister Inverted => JE: 下に灰色の逆斜め分割 / BE: 灰色の右下塗りつぶし
Green Per Bend Sinister Inverted => JE: 下に緑色の逆斜め分割 / BE: 緑の右下塗りつぶし
Light Blue Per Bend Sinister Inverted => JE: 下に空色の逆斜め分割 / BE: 空色の右下塗りつぶし
Lime Per Bend Sinister Inverted => JE: 下に黄緑色の逆斜め分割 / BE: 黄緑の右下塗りつぶし
Magenta Per Bend Sinister Inverted => JE: 下に赤紫色の逆斜め分割 / BE: 赤紫の右下塗りつぶし
Orange Per Bend Sinister Inverted => JE: 下に橙色の逆斜め分割 / BE: オレンジの右下塗りつぶし
Pink Per Bend Sinister Inverted => JE: 下に桃色の逆斜め分割 / BE: ピンクの右下塗りつぶし
Purple Per Bend Sinister Inverted => JE: 下に紫色の逆斜め分割 / BE: 紫の右下塗りつぶし
Red Per Bend Sinister Inverted => JE: 下に赤色の逆斜め分割 / BE: 赤の右下塗りつぶし
Light Gray Per Bend Sinister Inverted => JE: 下に薄灰色の逆斜め分割 / BE: 薄灰色の右下塗りつぶし
White Per Bend Sinister Inverted => JE: 下に白色の逆斜め分割 / BE: 白の右下塗りつぶし
Yellow Per Bend Sinister Inverted => JE: 下に黄色の逆斜め分割 / BE: 黄色の右下塗りつぶし
Black Flower Charge => JE: 黒色の花模様 / BE: 黒の花模様
Blue Flower Charge => JE: 青色の花模様 / BE: 青の花模様
Cyan Flower Charge => JE: 青緑色の花模様 / BE: 水色の花模様
Green Flower Charge => JE: 緑色の花模様 / BE: 緑の花模様
Lime Flower Charge => JE: 黄緑色の花模様 / BE: 黄緑の花模様
Magenta Flower Charge => JE: 赤紫色の花模様 / BE: 赤紫の花模様
Orange Flower Charge => JE: 橙色の花模様 / BE: オレンジの花模様
Pink Flower Charge => JE: 桃色の花模様 / BE: ピンクの花模様
Purple Flower Charge => JE: 紫色の花模様 / BE: 紫の花模様
Red Flower Charge => JE: 赤色の花模様 / BE: 赤の花模様
White Flower Charge => JE: 白色の花模様 / BE: 白の花模様
Black Gradient => JE: 上に黒色のグラデーション / BE: 黒の上方向グラデーション
Blue Gradient => JE: 上に青色のグラデーション / BE: 青の上方向グラデーション
Brown Gradient => JE: 上に茶色のグラデーション / BE: 茶色の上方向グラデーション
Cyan Gradient => JE: 上に青緑色のグラデーション / BE: 水色の上方向グラデーション
Gray Gradient => JE: 上に灰色のグラデーション / BE: 灰色の上方向グラデーション
Green Gradient => JE: 上に緑色のグラデーション / BE: 緑の上方向グラデーション
Light Blue Gradient => JE: 上に空色のグラデーション / BE: 空色の上方向グラデーション
Lime Gradient => JE: 上に黄緑色のグラデーション / BE: 黄緑の上方向グラデーション
Magenta Gradient => JE: 上に赤紫色のグラデーション / BE: 赤紫の上方向グラデーション
Orange Gradient => JE: 上に橙色のグラデーション / BE: オレンジの上方向グラデーション
Pink Gradient => JE: 上に桃色のグラデーション / BE: ピンクの上方向グラデーション
Purple Gradient => JE: 上に紫色のグラデーション / BE: 紫の上方向グラデーション
Red Gradient => JE: 上に赤色のグラデーション / BE: 赤の上方向グラデーション
Light Gray Gradient => JE: 上に薄灰色のグラデーション / BE: 薄灰色の上方向グラデーション
White Gradient => JE: 上に白色のグラデーション / BE: 白の上方向グラデーション
Yellow Gradient => JE: 上に黄色のグラデーション / BE: 黄色の上方向グラデーション
Black Base Gradient => JE: 下に黒色のグラデーション / BE: 黒の下方向グラデーション
Blue Base Gradient => JE: 下に青色のグラデーション / BE: 青の下方向グラデーション
Brown Base Gradient => JE: 下に茶色のグラデーション / BE: 茶色の下方向グラデーション
Cyan Base Gradient => JE: 下に青緑色のグラデーション / BE: 水色の下方向グラデーション
Gray Base Gradient => JE: 下に灰色のグラデーション / BE: 灰色の下方向グラデーション
Green Base Gradient => JE: 下に緑色のグラデーション / BE: 緑の下方向グラデーション
Light Blue Base Gradient => JE: 下に空色のグラデーション / BE: 空色の下方向グラデーション
Lime Base Gradient => JE: 下に黄緑色のグラデーション / BE: 黄緑の下方向グラデーション
Magenta Base Gradient => JE: 下に赤紫色のグラデーション / BE: 赤紫の下方向グラデーション
Orange Base Gradient => JE: 下に橙色のグラデーション / BE: オレンジの下方向グラデーション
Pink Base Gradient => JE: 下に桃色のグラデーション / BE: ピンクの下方向グラデーション
Purple Base Gradient => JE: 下に紫色のグラデーション / BE: 紫の下方向グラデーション
Red Base Gradient => JE: 下に赤色のグラデーション / BE: 赤の下方向グラデーション
Light Gray Base Gradient => JE: 下に薄灰色のグラデーション / BE: 薄灰色の下方向グラデーション
White Base Gradient => JE: 下に白色のグラデーション / BE: 白の下方向グラデーション
Yellow Base Gradient => JE: 下に黄色のグラデーション / BE: 黄色の下方向グラデーション
Green Banner => JE: 緑色の旗 / BE: 緑の旗
Black Per Fess => JE: 上に黒色の横二分割 / BE: 黒の上半分塗りつぶし
Blue Per Fess => JE: 上に青色の横二分割 / BE: 青の上半分塗りつぶし
Brown Per Fess => JE: 上に茶色の横二分割 / BE: 茶色の上半分塗りつぶし
Cyan Per Fess => JE: 上に青緑色の横二分割 / BE: 水色の上半分塗りつぶし
Gray Per Fess => JE: 上に灰色の横二分割 / BE: 灰色の上半分塗りつぶし
Green Per Fess => JE: 上に緑色の横二分割 / BE: 緑の上半分塗りつぶし
Light Blue Per Fess => JE: 上に空色の横二分割 / BE: 空色の上半分塗りつぶし
Lime Per Fess => JE: 上に黄緑色の横二分割 / BE: 黄緑の上半分塗りつぶし
Magenta Per Fess => JE: 上に赤紫色の横二分割 / BE: 赤紫の上半分塗りつぶし
Orange Per Fess => JE: 上に橙色の横二分割 / BE: オレンジの上半分塗りつぶし
Pink Per Fess => JE: 上に桃色の横二分割 / BE: ピンクの上半分塗りつぶし
Purple Per Fess => JE: 上に紫色の横二分割 / BE: 紫の上半分塗りつぶし
Red Per Fess => JE: 上に赤色の横二分割 / BE: 赤の上半分塗りつぶし
Light Gray Per Fess => JE: 上に薄灰色の横二分割 / BE: 薄灰色の上半分塗りつぶし
White Per Fess => JE: 上に白色の横二分割 / BE: 白の上半分塗りつぶし
Yellow Per Fess => JE: 上に黄色の横二分割 / BE: 黄色の上半分塗りつぶし
Black Per Fess Inverted => JE: 下に黒色の横二分割 / BE: 黒の下半分塗りつぶし
Blue Per Fess Inverted => JE: 下に青色の横二分割 / BE: 青の下半分塗りつぶし
Brown Per Fess Inverted => JE: 下に茶色の横二分割 / BE: 茶色の下半分塗りつぶし
Cyan Per Fess Inverted => JE: 下に青緑色の横二分割 / BE: 水色の下半分塗りつぶし
Gray Per Fess Inverted => JE: 下に灰色の横二分割 / BE: 灰色の下半分塗りつぶし
Green Per Fess Inverted => JE: 下に緑色の横二分割 / BE: 緑の下半分塗りつぶし
Light Blue Per Fess Inverted => JE: 下に空色の横二分割 / BE: 空色の下半分塗りつぶし
Lime Per Fess Inverted => JE: 下に黄緑色の横二分割 / BE: 黄緑の下半分塗りつぶし
Magenta Per Fess Inverted => JE: 下に赤紫色の横二分割 / BE: 赤紫の下半分塗りつぶし
Orange Per Fess Inverted => JE: 下に橙色の横二分割 / BE: オレンジの下半分塗りつぶし
Pink Per Fess Inverted => JE: 下に桃色の横二分割 / BE: ピンクの下半分塗りつぶし
Purple Per Fess Inverted => JE: 下に紫色の横二分割 / BE: 紫の下半分塗りつぶし
Red Per Fess Inverted => JE: 下に赤色の横二分割 / BE: 赤の下半分塗りつぶし
Light Gray Per Fess Inverted => JE: 下に薄灰色の横二分割 / BE: 薄灰色の下半分塗りつぶし
White Per Fess Inverted => JE: 下に白色の横二分割 / BE: 白の下半分塗りつぶし
Yellow Per Fess Inverted => JE: 下に黄色の横二分割 / BE: 黄色の下半分塗りつぶし
Black Per Pale => JE: 右に黒色の縦二分割 / BE: 黒の左半分塗りつぶし
Blue Per Pale => JE: 右に青色の縦二分割 / BE: 青の左半分塗りつぶし
Brown Per Pale => JE: 右に茶色の縦二分割 / BE: 茶色の左半分塗りつぶし
Cyan Per Pale => JE: 右に青緑色の縦二分割 / BE: 水色の左半分塗りつぶし
Gray Per Pale => JE: 右に灰色の縦二分割 / BE: 灰色の左半分塗りつぶし
Green Per Pale => JE: 右に緑色の縦二分割 / BE: 緑の左半分塗りつぶし
Light Blue Per Pale => JE: 右に空色の縦二分割 / BE: 空色の左半分塗りつぶし
Lime Per Pale => JE: 右に黄緑色の縦二分割 / BE: 黄緑の左半分塗りつぶし
Magenta Per Pale => JE: 右に赤紫色の縦二分割 / BE: 赤紫の左半分塗りつぶし
Orange Per Pale => JE: 右に橙色の縦二分割 / BE: オレンジの左半分塗りつぶし
Pink Per Pale => JE: 右に桃色の縦二分割 / BE: ピンクの左半分塗りつぶし
Purple Per Pale => JE: 右に紫色の縦二分割 / BE: 紫の左半分塗りつぶし
Red Per Pale => JE: 右に赤色の縦二分割 / BE: 赤の左半分塗りつぶし
Light Gray Per Pale => JE: 右に薄灰色の縦二分割 / BE: 薄灰色の左半分塗りつぶし
White Per Pale => JE: 右に白色の縦二分割 / BE: 白の左半分塗りつぶし
Yellow Per Pale => JE: 右に黄色の縦二分割 / BE: 黄色の左半分塗りつぶし
Black Per Pale Inverted => JE: 左に黒色の縦二分割 / BE: 黒の右半分塗りつぶし
Blue Per Pale Inverted => JE: 左に青色の縦二分割 / BE: 青の右半分塗りつぶし
Brown Per Pale Inverted => JE: 左に茶色の縦二分割 / BE: 茶色の右半分塗りつぶし
Cyan Per Pale Inverted => JE: 左に青緑色の縦二分割 / BE: 水色の右半分塗りつぶし
Gray Per Pale Inverted => JE: 左に灰色の縦二分割 / BE: 灰色の右半分塗りつぶし
Green Per Pale Inverted => JE: 左に緑色の縦二分割 / BE: 緑の右半分塗りつぶし
Light Blue Per Pale Inverted => JE: 左に空色の縦二分割 / BE: 空色の右半分塗りつぶし
Lime Per Pale Inverted => JE: 左に黄緑色の縦二分割 / BE: 黄緑の右半分塗りつぶし
Magenta Per Pale Inverted => JE: 左に赤紫色の縦二分割 / BE: 赤紫の右半分塗りつぶし
Orange Per Pale Inverted => JE: 左に橙色の縦二分割 / BE: オレンジの右半分塗りつぶし
Pink Per Pale Inverted => JE: 左に桃色の縦二分割 / BE: ピンクの右半分塗りつぶし
Purple Per Pale Inverted => JE: 左に紫色の縦二分割 / BE: 紫の右半分塗りつぶし
Red Per Pale Inverted => JE: 左に赤色の縦二分割 / BE: 赤の右半分塗りつぶし
Light Gray Per Pale Inverted => JE: 左に薄灰色の縦二分割 / BE: 薄灰色の右半分塗りつぶし
White Per Pale Inverted => JE: 左に白色の縦二分割 / BE: 白の右半分塗りつぶし
Yellow Per Pale Inverted => JE: 左に黄色の縦二分割 / BE: 黄色の右半分塗りつぶし
Lime Banner => JE: 黄緑色の旗 / BE: 黄緑の旗
Magenta Banner => JE: 赤紫色の旗 / BE: 赤紫の旗
Black Thing => JE: 黒色の何かの模様 / BE: 黒の何かの模様
Blue Thing => JE: 青色の何かの模様 / BE: 青の何かの模様
Cyan Thing => JE: 青緑色の何かの模様 / BE: 水色の何かの模様
Green Thing => JE: 緑色の何かの模様 / BE: 緑の何かの模様
Lime Thing => JE: 黄緑色の何かの模様 / BE: 黄緑の何かの模様
Magenta Thing => JE: 赤紫色の何かの模様 / BE: 赤紫の何かの模様
Orange Thing => JE: 橙色の何かの模様 / BE: オレンジの何かの模様
Pink Thing => JE: 桃色の何かの模様 / BE: ピンクの何かの模様
Purple Thing => JE: 紫色の何かの模様 / BE: 紫の何かの模様
Red Thing => JE: 赤色の何かの模様 / BE: 赤の何かの模様
White Thing => JE: 白色の何かの模様 / BE: 白の何かの模様
Orange Banner => JE: 橙色の旗 / BE: オレンジの旗
Black Snout => JE: 黒色のブタの鼻の模様 / BE: 豚の鼻 (黒)
Blue Snout => JE: 青色のブタの鼻の模様 / BE: 豚の鼻 (青)
Brown Snout => JE: 茶色のブタの鼻の模様 / BE: 豚の鼻 (茶色)
Cyan Snout => JE: 青緑色のブタの鼻の模様 / BE: 豚の鼻 (水色)
Gray Snout => JE: 灰色のブタの鼻の模様 / BE: 豚の鼻 (灰色)
Green Snout => JE: 緑色のブタの鼻の模様 / BE: 豚の鼻 (緑)
Light Blue Snout => JE: 空色のブタの鼻の模様 / BE: 豚の鼻 (空色)
Lime Snout => JE: 黄緑色のブタの鼻の模様 / BE: 豚の鼻 (黄緑)
Magenta Snout => JE: 赤紫色のブタの鼻の模様 / BE: 豚の鼻 (赤紫)
Orange Snout => JE: 橙色のブタの鼻の模様 / BE: 豚の鼻 (オレンジ)
Pink Snout => JE: 桃色のブタの鼻の模様 / BE: 豚の鼻 (ピンク)
Purple Snout => JE: 紫色のブタの鼻の模様 / BE: 豚の鼻 (紫)
Red Snout => JE: 赤色のブタの鼻の模様 / BE: 豚の鼻 (赤)
Light Gray Snout => JE: 薄灰色のブタの鼻の模様 / BE: 豚の鼻 (薄灰色)
White Snout => JE: 白色のブタの鼻の模様 / BE: 豚の鼻 (白)
Yellow Snout => JE: 黄色のブタの鼻の模様 / BE: 豚の鼻 (黄色)
Pink Banner => JE: 桃色の旗 / BE: ピンクの旗
Purple Banner => JE: 紫色の旗 / BE: 紫の旗
Red Banner => JE: 赤色の旗 / BE: 赤の旗
Black Lozenge => JE: 黒色の菱形 / BE: 黒の菱形
Blue Lozenge => JE: 青色の菱形 / BE: 青の菱形
Cyan Lozenge => JE: 青緑色の菱形 / BE: 水色の菱形
Green Lozenge => JE: 緑色の菱形 / BE: 緑の菱形
Lime Lozenge => JE: 黄緑色の菱形 / BE: 黄緑の菱形
Magenta Lozenge => JE: 赤紫色の菱形 / BE: 赤紫の菱形
Orange Lozenge => JE: 橙色の菱形 / BE: オレンジの菱形
Pink Lozenge => JE: 桃色の菱形 / BE: ピンクの菱形
Purple Lozenge => JE: 紫色の菱形 / BE: 紫の菱形
Red Lozenge => JE: 赤色の菱形 / BE: 赤の菱形
White Lozenge => JE: 白色の菱形 / BE: 白の菱形
Black Skull Charge => JE: 黒色の骸骨模様 / BE: 黒の骸骨模様
Blue Skull Charge => JE: 青色の骸骨模様 / BE: 青の骸骨模様
Cyan Skull Charge => JE: 青緑色の骸骨模様 / BE: 水色の骸骨模様
Green Skull Charge => JE: 緑色の骸骨模様 / BE: 緑の骸骨模様
Lime Skull Charge => JE: 黄緑色の骸骨模様 / BE: 黄緑の骸骨模様
Magenta Skull Charge => JE: 赤紫色の骸骨模様 / BE: 赤紫の骸骨模様
Orange Skull Charge => JE: 橙色の骸骨模様 / BE: オレンジの骸骨模様
Pink Skull Charge => JE: 桃色の骸骨模様 / BE: ピンクの骸骨模様
Purple Skull Charge => JE: 紫色の骸骨模様 / BE: 紫の骸骨模様
Red Skull Charge => JE: 赤色の骸骨模様 / BE: 赤の骸骨模様
White Skull Charge => JE: 白色の骸骨模様 / BE: 白の骸骨模様
Black Paly => JE: 黒色の縦縞 / BE: 黒の縦縞
Blue Paly => JE: 青色の縦縞 / BE: 青の縦縞
Cyan Paly => JE: 青緑色の縦縞 / BE: 水色の縦縞
Green Paly => JE: 緑色の縦縞 / BE: 緑の縦縞
Lime Paly => JE: 黄緑色の縦縞 / BE: 黄緑の縦縞
Magenta Paly => JE: 赤紫色の縦縞 / BE: 赤紫の縦縞
Orange Paly => JE: 橙色の縦縞 / BE: オレンジの縦縞
Pink Paly => JE: 桃色の縦縞 / BE: ピンクの縦縞
Purple Paly => JE: 紫色の縦縞 / BE: 紫の縦縞
Red Paly => JE: 赤色の縦縞 / BE: 赤の縦縞
White Paly => JE: 白色の縦縞 / BE: 白の縦縞
Black Base Dexter Canton => JE: 右下に黒色の方形 / BE: 左下に黒の模様入り
Blue Base Dexter Canton => JE: 右下に青色の方形 / BE: 左下に青の模様入り
Brown Base Dexter Canton => JE: 右下に茶色の方形 / BE: 左下に茶色の模様入り
Cyan Base Dexter Canton => JE: 右下に青緑色の方形 / BE: 左下に水色の模様入り
Gray Base Dexter Canton => JE: 右下に灰色の方形 / BE: 左下に灰色の模様入り
Green Base Dexter Canton => JE: 右下に緑色の方形 / BE: 左下に緑の模様入り
Light Blue Base Dexter Canton => JE: 右下に空色の方形 / BE: 左下に空色の模様入り
Lime Base Dexter Canton => JE: 右下に黄緑色の方形 / BE: 左下に黄緑の模様入り
Magenta Base Dexter Canton => JE: 右下に赤紫色の方形 / BE: 左下に赤紫の模様入り
Orange Base Dexter Canton => JE: 右下に橙色の方形 / BE: 左下にオレンジの模様入り
Pink Base Dexter Canton => JE: 右下に桃色の方形 / BE: 左下にピンクの模様入り
Purple Base Dexter Canton => JE: 右下に紫色の方形 / BE: 左下に紫の模様入り
Red Base Dexter Canton => JE: 右下に赤色の方形 / BE: 左下に赤の模様入り
Light Gray Base Dexter Canton => JE: 右下に薄灰色の方形 / BE: 左下に薄灰色の模様入り
White Base Dexter Canton => JE: 右下に白色の方形 / BE: 左下に白の模様入り
Yellow Base Dexter Canton => JE: 右下に黄色の方形 / BE: 左下に黄色の模様入り
Black Base Sinister Canton => JE: 左下に黒色の方形 / BE: 右下に黒の模様入り
Blue Base Sinister Canton => JE: 左下に青色の方形 / BE: 右下に青の模様入り
Brown Base Sinister Canton => JE: 左下に茶色の方形 / BE: 右下に茶色の模様入り
Cyan Base Sinister Canton => JE: 左下に青緑色の方形 / BE: 右下に水色の模様入り
Gray Base Sinister Canton => JE: 左下に灰色の方形 / BE: 右下に灰色の模様入り
Green Base Sinister Canton => JE: 左下に緑色の方形 / BE: 右下に緑の模様入り
Light Blue Base Sinister Canton => JE: 左下に空色の方形 / BE: 右下に空色の模様入り
Lime Base Sinister Canton => JE: 左下に黄緑色の方形 / BE: 右下に黄緑の模様入り
Magenta Base Sinister Canton => JE: 左下に赤紫色の方形 / BE: 右下に赤紫の模様入り
Orange Base Sinister Canton => JE: 左下に橙色の方形 / BE: 右下にオレンジの模様入り
Pink Base Sinister Canton => JE: 左下に桃色の方形 / BE: 右下にピンクの模様入り
Purple Base Sinister Canton => JE: 左下に紫色の方形 / BE: 右下に紫の模様入り
Red Base Sinister Canton => JE: 左下に赤色の方形 / BE: 右下に赤の模様入り
Light Gray Base Sinister Canton => JE: 左下に薄灰色の方形 / BE: 右下に薄灰色の模様入り
White Base Sinister Canton => JE: 左下に白色の方形 / BE: 右下に白の模様入り
Yellow Base Sinister Canton => JE: 左下に黄色の方形 / BE: 右下に黄色の模様入り
Black Chief Dexter Canton => JE: 右上に黒色の方形 / BE: 左上に黒の模様入り
Blue Chief Dexter Canton => JE: 右上に青色の方形 / BE: 左上に青の模様入り
Brown Chief Dexter Canton => JE: 右上に茶色の方形 / BE: 左上に茶色の模様入り
Cyan Chief Dexter Canton => JE: 右上に青緑色の方形 / BE: 左上に水色の模様入り
Gray Chief Dexter Canton => JE: 右上に灰色の方形 / BE: 左上に灰色の模様入り
Green Chief Dexter Canton => JE: 右上に緑色の方形 / BE: 左上に緑の模様入り
Light Blue Chief Dexter Canton => JE: 右上に空色の方形 / BE: 左上に空色の模様入り
Lime Chief Dexter Canton => JE: 右上に黄緑色の方形 / BE: 左上に黄緑の模様入り
Magenta Chief Dexter Canton => JE: 右上に赤紫色の方形 / BE: 左上に赤紫の模様入り
Orange Chief Dexter Canton => JE: 右上に橙色の方形 / BE: 左上にオレンジの模様入り
Pink Chief Dexter Canton => JE: 右上に桃色の方形 / BE: 左上にピンクの模様入り
Purple Chief Dexter Canton => JE: 右上に紫色の方形 / BE: 左上に紫の模様入り
Red Chief Dexter Canton => JE: 右上に赤色の方形 / BE: 左上に赤の模様入り
Light Gray Chief Dexter Canton => JE: 右上に薄灰色の方形 / BE: 左上に薄灰色の模様入り
White Chief Dexter Canton => JE: 右上に白色の方形 / BE: 左上に白の模様入り
Yellow Chief Dexter Canton => JE: 右上に黄色の方形 / BE: 左上に黄色の模様入り
Black Chief Sinister Canton => JE: 左上に黒色の方形 / BE: 右上に黒の模様入り
Blue Chief Sinister Canton => JE: 左上に青色の方形 / BE: 右上に青の模様入り
Brown Chief Sinister Canton => JE: 左上に茶色の方形 / BE: 右上に茶色の模様入り
Cyan Chief Sinister Canton => JE: 左上に青緑色の方形 / BE: 右上に水色の模様入り
Gray Chief Sinister Canton => JE: 左上に灰色の方形 / BE: 右上に灰色の模様入り
Green Chief Sinister Canton => JE: 左上に緑色の方形 / BE: 右上に緑の模様入り
Light Blue Chief Sinister Canton => JE: 左上に空色の方形 / BE: 右上に空色の模様入り
Lime Chief Sinister Canton => JE: 左上に黄緑色の方形 / BE: 右上に黄緑の模様入り
Magenta Chief Sinister Canton => JE: 左上に赤紫色の方形 / BE: 右上に赤紫の模様入り
Orange Chief Sinister Canton => JE: 左上に橙色の方形 / BE: 右上にオレンジの模様入り
Pink Chief Sinister Canton => JE: 左上に桃色の方形 / BE: 右上にピンクの模様入り
Purple Chief Sinister Canton => JE: 左上に紫色の方形 / BE: 右上に紫の模様入り
Red Chief Sinister Canton => JE: 左上に赤色の方形 / BE: 右上に赤の模様入り
Light Gray Chief Sinister Canton => JE: 左上に薄灰色の方形 / BE: 右上に薄灰色の模様入り
White Chief Sinister Canton => JE: 左上に白色の方形 / BE: 右上に白の模様入り
Yellow Chief Sinister Canton => JE: 左上に黄色の方形 / BE: 右上に黄色の模様入り
Black Cross => JE: 黒色の十字 / BE: 黒の十字
Blue Cross => JE: 青色の十字 / BE: 青の十字
Cyan Cross => JE: 青緑色の十字 / BE: 水色の十字
Green Cross => JE: 緑色の十字 / BE: 緑の十字
Lime Cross => JE: 黄緑色の十字 / BE: 黄緑の十字
Magenta Cross => JE: 赤紫色の十字 / BE: 赤紫の十字
Orange Cross => JE: 橙色の十字 / BE: オレンジの十字
Pink Cross => JE: 桃色の十字 / BE: ピンクの十字
Purple Cross => JE: 紫色の十字 / BE: 紫の十字
Red Cross => JE: 赤色の十字 / BE: 赤の十字
White Cross => JE: 白色の十字 / BE: 白の十字
Black Pale => JE: 黒色の縦帯 / BE: 中央に黒の縦帯入り
Blue Pale => JE: 青色の縦帯 / BE: 中央に青の縦帯入り
Brown Pale => JE: 茶色の縦帯 / BE: 中央に茶色の縦帯入り
Cyan Pale => JE: 青緑色の縦帯 / BE: 中央に水色の縦帯入り
Gray Pale => JE: 灰色の縦帯 / BE: 中央に灰色の縦帯入り
Green Pale => JE: 緑色の縦帯 / BE: 中央に緑の縦帯入り
Light Blue Pale => JE: 空色の縦帯 / BE: 中央に空色の縦帯入り
Lime Pale => JE: 黄緑色の縦帯 / BE: 中央に黄緑の縦帯入り
Magenta Pale => JE: 赤紫色の縦帯 / BE: 中央に赤紫の縦帯入り
Orange Pale => JE: 橙色の縦帯 / BE: 中央にオレンジの縦帯入り
Pink Pale => JE: 桃色の縦帯 / BE: 中央にピンクの縦帯入り
Purple Pale => JE: 紫色の縦帯 / BE: 中央に紫の縦帯入り
Red Pale => JE: 赤色の縦帯 / BE: 中央に赤の縦帯入り
Light Gray Pale => JE: 薄灰色の縦帯 / BE: 中央に薄灰色の縦帯入り
White Pale => JE: 白色の縦帯 / BE: 中央に白の縦帯入り
Yellow Pale => JE: 黄色の縦帯 / BE: 中央に黄色の縦帯入り
Black Bend Sinister => JE: 黒色の逆斜め帯 / BE: 黒の左斜め下向き襷模様
Blue Bend Sinister => JE: 青色の逆斜め帯 / BE: 青の左斜め下向き襷模様
Brown Bend Sinister => JE: 茶色の逆斜め帯 / BE: 茶色の左斜め下向き襷模様
Cyan Bend Sinister => JE: 青緑色の逆斜め帯 / BE: 水色の左斜め下向き襷模様
Gray Bend Sinister => JE: 灰色の逆斜め帯 / BE: 灰色の左斜め下向き襷模様
Green Bend Sinister => JE: 緑色の逆斜め帯 / BE: 緑の左斜め下向き襷模様
Light Blue Bend Sinister => JE: 空色の逆斜め帯 / BE: 空色の左斜め下向き襷模様
Lime Bend Sinister => JE: 黄緑色の逆斜め帯 / BE: 黄緑の左斜め下向き襷模様
Magenta Bend Sinister => JE: 赤紫色の逆斜め帯 / BE: 赤紫の左斜め下向き襷模様
Orange Bend Sinister => JE: 橙色の逆斜め帯 / BE: オレンジの左斜め下向き襷模様
Pink Bend Sinister => JE: 桃色の逆斜め帯 / BE: ピンクの左斜め下向き襷模様
Purple Bend Sinister => JE: 紫色の逆斜め帯 / BE: 紫の左斜め下向き襷模様
Red Bend Sinister => JE: 赤色の逆斜め帯 / BE: 赤の左斜め下向き襷模様
Light Gray Bend Sinister => JE: 薄灰色の逆斜め帯 / BE: 薄灰色の左斜め下向き襷模様
White Bend Sinister => JE: 白色の逆斜め帯 / BE: 白の左斜め下向き襷模様
Yellow Bend Sinister => JE: 黄色の逆斜め帯 / BE: 黄色の左斜め下向き襷模様
Black Bend => JE: 黒色の斜め帯 / BE: 黒の右斜め下向き襷模様
Blue Bend => JE: 青色の斜め帯 / BE: 青の右斜め下向き襷模様
Brown Bend => JE: 茶色の斜め帯 / BE: 茶色の右斜め下向き襷模様
Cyan Bend => JE: 青緑色の斜め帯 / BE: 水色の右斜め下向き襷模様
Gray Bend => JE: 灰色の斜め帯 / BE: 灰色の右斜め下向き襷模様
Green Bend => JE: 緑色の斜め帯 / BE: 緑の右斜め下向き襷模様
Light Blue Bend => JE: 空色の斜め帯 / BE: 空色の右斜め下向き襷模様
Lime Bend => JE: 黄緑色の斜め帯 / BE: 黄緑の右斜め下向き襷模様
Magenta Bend => JE: 赤紫色の斜め帯 / BE: 赤紫の右斜め下向き襷模様
Orange Bend => JE: 橙色の斜め帯 / BE: オレンジの右斜め下向き襷模様
Pink Bend => JE: 桃色の斜め帯 / BE: ピンクの右斜め下向き襷模様
Purple Bend => JE: 紫色の斜め帯 / BE: 紫の右斜め下向き襷模様
Red Bend => JE: 赤色の斜め帯 / BE: 赤の右斜め下向き襷模様
Light Gray Bend => JE: 薄灰色の斜め帯 / BE: 薄灰色の右斜め下向き襷模様
White Bend => JE: 白色の斜め帯 / BE: 白の右斜め下向き襷模様
Yellow Bend => JE: 黄色の斜め帯 / BE: 黄色の右斜め下向き襷模様
Black Pale Dexter => JE: 右に黒色の縦帯 / BE: 左に黒の縦帯入り
Blue Pale Dexter => JE: 右に青色の縦帯 / BE: 左に青の縦帯入り
Brown Pale Dexter => JE: 右に茶色の縦帯 / BE: 左に茶色の縦帯入り
Cyan Pale Dexter => JE: 右に青緑色の縦帯 / BE: 左に水色の縦帯入り
Gray Pale Dexter => JE: 右に灰色の縦帯 / BE: 左に灰色の縦帯入り
Green Pale Dexter => JE: 右に緑色の縦帯 / BE: 左に緑の縦帯入り
Light Blue Pale Dexter => JE: 右に空色の縦帯 / BE: 左に空色の縦帯入り
Lime Pale Dexter => JE: 右に黄緑色の縦帯 / BE: 左に黄緑の縦帯入り
Magenta Pale Dexter => JE: 右に赤紫色の縦帯 / BE: 左に赤紫の縦帯入り
Orange Pale Dexter => JE: 右に橙色の縦帯 / BE: 左にオレンジの縦帯入り
Pink Pale Dexter => JE: 右に桃色の縦帯 / BE: 左にピンクの縦帯入り
Purple Pale Dexter => JE: 右に紫色の縦帯 / BE: 左に紫の縦帯入り
Red Pale Dexter => JE: 右に赤色の縦帯 / BE: 左に赤の縦帯入り
Light Gray Pale Dexter => JE: 右に薄灰色の縦帯 / BE: 左に薄灰色の縦帯入り
White Pale Dexter => JE: 右に白色の縦帯 / BE: 左に白の縦帯入り
Yellow Pale Dexter => JE: 右に黄色の縦帯 / BE: 左に黄色の縦帯入り
Black Fess => JE: 黒色の横帯 / BE: 中央に黒の横帯入り
Blue Fess => JE: 青色の横帯 / BE: 中央に青の横帯入り
Brown Fess => JE: 茶色の横帯 / BE: 中央に茶色の横帯入り
Cyan Fess => JE: 青緑色の横帯 / BE: 中央に水色の横帯入り
Gray Fess => JE: 灰色の横帯 / BE: 中央に灰色の横帯入り
Green Fess => JE: 緑色の横帯 / BE: 中央に緑の横帯入り
Light Blue Fess => JE: 空色の横帯 / BE: 中央に空色の横帯入り
Lime Fess => JE: 黄緑色の横帯 / BE: 中央に黄緑の横帯入り
Magenta Fess => JE: 赤紫色の横帯 / BE: 中央に赤紫の横帯入り
Orange Fess => JE: 橙色の横帯 / BE: 中央にオレンジの横帯入り
Pink Fess => JE: 桃色の横帯 / BE: 中央にピンクの横帯入り
Purple Fess => JE: 紫色の横帯 / BE: 中央に紫の横帯入り
Red Fess => JE: 赤色の横帯 / BE: 中央に赤の横帯入り
Light Gray Fess => JE: 薄灰色の横帯 / BE: 中央に薄灰色の横帯入り
White Fess => JE: 白色の横帯 / BE: 中央に白の横帯入り
Yellow Fess => JE: 黄色の横帯 / BE: 中央に黄色の横帯入り
Black Pale Sinister => JE: 左に黒色の縦帯 / BE: 右に黒の縦帯入り
Blue Pale Sinister => JE: 左に青色の縦帯 / BE: 右に青の縦帯入り
Brown Pale Sinister => JE: 左に茶色の縦帯 / BE: 右に茶色の縦帯入り
Cyan Pale Sinister => JE: 左に青緑色の縦帯 / BE: 右に水色の縦帯入り
Gray Pale Sinister => JE: 左に灰色の縦帯 / BE: 右に灰色の縦帯入り
Green Pale Sinister => JE: 左に緑色の縦帯 / BE: 右に緑の縦帯入り
Light Blue Pale Sinister => JE: 左に空色の縦帯 / BE: 右に空色の縦帯入り
Lime Pale Sinister => JE: 左に黄緑色の縦帯 / BE: 右に黄緑の縦帯入り
Magenta Pale Sinister => JE: 左に赤紫色の縦帯 / BE: 右に赤紫の縦帯入り
Orange Pale Sinister => JE: 左に橙色の縦帯 / BE: 右にオレンジの縦帯入り
Pink Pale Sinister => JE: 左に桃色の縦帯 / BE: 右にピンクの縦帯入り
Purple Pale Sinister => JE: 左に紫色の縦帯 / BE: 右に紫の縦帯入り
Red Pale Sinister => JE: 左に赤色の縦帯 / BE: 右に赤の縦帯入り
Light Gray Pale Sinister => JE: 左に薄灰色の縦帯 / BE: 右に薄灰色の縦帯入り
White Pale Sinister => JE: 左に白色の縦帯 / BE: 右に白の縦帯入り
Yellow Pale Sinister => JE: 左に黄色の縦帯 / BE: 右に黄色の縦帯入り
Black Chevron => JE: 黒色の山形 / BE: 黒の上向き三角
Blue Chevron => JE: 青色の山形 / BE: 青の上向き三角
Brown Chevron => JE: 茶色の山形 / BE: 茶色の上向き三角
Cyan Chevron => JE: 青緑色の山形 / BE: 水色の上向き三角
Gray Chevron => JE: 灰色の山形 / BE: 灰色の上向き三角
Green Chevron => JE: 緑色の山形 / BE: 緑の上向き三角
Light Blue Chevron => JE: 空色の山形 / BE: 空色の上向き三角
Lime Chevron => JE: 黄緑色の山形 / BE: 黄緑の上向き三角
Magenta Chevron => JE: 赤紫色の山形 / BE: 赤紫の上向き三角
Orange Chevron => JE: 橙色の山形 / BE: オレンジの上向き三角
Pink Chevron => JE: 桃色の山形 / BE: ピンクの上向き三角
Purple Chevron => JE: 紫色の山形 / BE: 紫の上向き三角
Red Chevron => JE: 赤色の山形 / BE: 赤の上向き三角
Light Gray Chevron => JE: 薄灰色の山形 / BE: 薄灰色の上向き三角
White Chevron => JE: 白色の山形 / BE: 白の上向き三角
Yellow Chevron => JE: 黄色の山形 / BE: 黄色の上向き三角
Black Inverted Chevron => JE: 黒色の下向きの山形 / BE: 黒の下向き三角
Blue Inverted Chevron => JE: 青色の下向きの山形 / BE: 青の下向き三角
Brown Inverted Chevron => JE: 茶色の下向きの山形 / BE: 茶色の下向き三角
Cyan Inverted Chevron => JE: 青緑色の下向きの山形 / BE: 水色の下向き三角
Gray Inverted Chevron => JE: 灰色の下向きの山形 / BE: 灰色の下向き三角
Green Inverted Chevron => JE: 緑色の下向きの山形 / BE: 緑の下向き三角
Light Blue Inverted Chevron => JE: 空色の下向きの山形 / BE: 空色の下向き三角
Lime Inverted Chevron => JE: 黄緑色の下向きの山形 / BE: 黄緑の下向き三角
Magenta Inverted Chevron => JE: 赤紫色の下向きの山形 / BE: 赤紫の下向き三角
Orange Inverted Chevron => JE: 橙色の下向きの山形 / BE: オレンジの下向き三角
Pink Inverted Chevron => JE: 桃色の下向きの山形 / BE: ピンクの下向き三角
Purple Inverted Chevron => JE: 紫色の下向きの山形 / BE: 紫の下向き三角
Red Inverted Chevron => JE: 赤色の下向きの山形 / BE: 赤の下向き三角
Light Gray Inverted Chevron => JE: 薄灰色の下向きの山形 / BE: 薄灰色の下向き三角
White Inverted Chevron => JE: 白色の下向きの山形 / BE: 白の下向き三角
Yellow Inverted Chevron => JE: 黄色の下向きの山形 / BE: 黄色の下向き三角
Black Base Indented => JE: 下に黒色の波形 / BE: 黒の上向き波形
Blue Base Indented => JE: 下に青色の波形 / BE: 青の上向き波形
Brown Base Indented => JE: 下に茶色の波形 / BE: 茶色の上向き波形
Cyan Base Indented => JE: 下に青緑色の波形 / BE: 水色の上向き波形
Gray Base Indented => JE: 下に灰色の波形 / BE: 灰色の上向き波形
Green Base Indented => JE: 下に緑色の波形 / BE: 緑の上向き波形
Light Blue Base Indented => JE: 下に空色の波形 / BE: 空色の上向き波形
Lime Base Indented => JE: 下に黄緑色の波形 / BE: 黄緑の上向き波形
Magenta Base Indented => JE: 下に赤紫色の波形 / BE: 赤紫の上向き波形
Orange Base Indented => JE: 下に橙色の波形 / BE: オレンジの上向き波形
Pink Base Indented => JE: 下に桃色の波形 / BE: ピンクの上向き波形
Purple Base Indented => JE: 下に紫色の波形 / BE: 紫の上向き波形
Red Base Indented => JE: 下に赤色の波形 / BE: 赤の上向き波形
Light Gray Base Indented => JE: 下に薄灰色の波形 / BE: 薄灰色の上向き波形
White Base Indented => JE: 下に白色の波形 / BE: 白の上向き波形
Yellow Base Indented => JE: 下に黄色の波形 / BE: 黄色の上向き波形
Black Chief Indented => JE: 上に黒色の波形 / BE: 黒の下向き波形
Blue Chief Indented => JE: 上に青色の波形 / BE: 青の下向き波形
Brown Chief Indented => JE: 上に茶色の波形 / BE: 茶色の下向き波形
Cyan Chief Indented => JE: 上に青緑色の波形 / BE: 水色の下向き波形
Gray Chief Indented => JE: 上に灰色の波形 / BE: 灰色の下向き波形
Green Chief Indented => JE: 上に緑色の波形 / BE: 緑の下向き波形
Light Blue Chief Indented => JE: 上に空色の波形 / BE: 空色の下向き波形
Lime Chief Indented => JE: 上に黄緑色の波形 / BE: 黄緑の下向き波形
Magenta Chief Indented => JE: 上に赤紫色の波形 / BE: 赤紫の下向き波形
Orange Chief Indented => JE: 上に橙色の波形 / BE: オレンジの下向き波形
Pink Chief Indented => JE: 上に桃色の波形 / BE: ピンクの下向き波形
Purple Chief Indented => JE: 上に紫色の波形 / BE: 紫の下向き波形
Red Chief Indented => JE: 上に赤色の波形 / BE: 赤の下向き波形
Light Gray Chief Indented => JE: 上に薄灰色の波形 / BE: 薄灰色の下向き波形
White Chief Indented => JE: 上に白色の波形 / BE: 白の下向き波形
Yellow Chief Indented => JE: 上に黄色の波形 / BE: 黄色の下向き波形
White Banner => JE: 白色の旗 / BE: 白の旗
Black Bed => JE: 黒色のベッド / BE: 黒のベッド
Red Bed => JE: 赤色のベッド / BE: 赤のベッド
Blue Bed => JE: 青色のベッド / BE: 青のベッド
Purple Bed => JE: 紫色のベッド / BE: 紫のベッド
Cyan Bed => JE: 青緑色のベッド / BE: 水色のベッド
Pink Bed => JE: 桃色のベッド / BE: ピンクのベッド
Lime Bed => JE: 黄緑色のベッド / BE: 黄緑のベッド
Magenta Bed => JE: 赤紫色のベッド / BE: 赤紫のベッド
Orange Bed => JE: 橙色のベッド / BE: オレンジのベッド
White Bed => JE: 白色のベッド / BE: 白のベッド
Bell => JE: 鐘 / BE: ベル
Beetroot Soup => JE: ビートルートスープ / BE: ビートルート スープ
Blaze Powder => JE: ブレイズパウダー / BE: ブレイズ パウダー
Blaze Rod => JE: ブレイズロッド / BE: ブレイズ ロッド
Oak Boat => JE: オークのボート / BE: 樫の木のボート
Birch Boat => JE: シラカバのボート / BE: 樺のボート
Jungle Boat => JE: ジャングルのボート / BE: ジャングルの木のボート
Dark Oak Boat => JE: ダークオークのボート / BE: 黒樫の木のボート
Bowl => JE: ボウル / BE: おわん
Lava Bucket => JE: 溶岩入りバケツ / BE: 溶岩バケツ
Water Bucket => JE: 水入りバケツ / BE: 水バケツ
Bucket of Cod => JE: タラ入りバケツ / BE: バケツ 1 杯のタラ
Bucket of Salmon => JE: サケ入りバケツ / BE: バケツ 1 杯の鮭
Bucket of Tropical Fish => JE: 熱帯魚入りバケツ / BE: バケツ 1 杯の熱帯魚
Bucket of Pufferfish => JE: フグ入りバケツ / BE: バケツ 1 杯のフグ
Orange => JE: 橙色 / BE: オレンジ
Magenta => JE: 赤紫色 / BE: 赤紫
Lime => JE: 黄緑色 / BE: 黄緑
Anemone => JE: アネモネ / BE: クマノミ
Black Tang => JE: ヒレナガハギ / BE: クロハギ
Cotton Candy Betta => JE: ベタ / BE: わたあめベタ
Emperor Red Snapper => JE: センネンダイ / BE: コウテイ レッドスナッパー
Red Cichlid => JE: レッドシクリッド / BE: レッド シクリッド
Red Lipped Blenny => JE: イソギンポ / BE: レッド リップド ブレニー
Red Snapper => JE: フエダイ / BE: レッドスナッパー
Can break: => JE: 破壊可能： / BE: 破壊可能なもの:
Can be placed on: => JE: 設置可能： / BE: 配置可能なもの:
Warped Fungus on a Stick => JE: 歪んだキノコ付きの棒 / BE: ゆがんだきのこ付きの棒
Leather Tunic => JE: 革の上着 / BE: 革の服
Diamond Chestplate => JE: ダイヤモンドのチェストプレート / BE: ダイヤモンドの胸当て
Golden Chestplate => JE: 金のチェストプレート / BE: 金の胸当て
Iron Chestplate => JE: 鉄のチェストプレート / BE: 鉄の胸当て
Chorus Fruit => JE: コーラスフルーツ / BE: コーラス フルーツ
Popped Chorus Fruit => JE: 焼いたコーラスフルーツ / BE: 焼いたコーラス フルーツ
Cooked Porkchop => JE: 焼き豚 / BE: 調理した豚肉
Redstone Comparator => JE: レッドストーンコンパレーター / BE: レッドストーン コンパレーター
Lodestone Compass => JE: ロードストーンコンパス / BE: ロデストーン コンパス
Redstone Repeater => JE: レッドストーンリピーター / BE: レッドストーン反復装置
Birch Door => JE: シラカバのドア / BE: 樺の木のドア
Dark Oak Door => JE: ダークオークのドア / BE: 黒樫の木のドア
Jungle Door => JE: ジャングルのドア / BE: ジャングルの木のドア
Oak Door => JE: オークのドア / BE: 樫の木のドア
Spruce Door => JE: トウヒのドア / BE: トウヒの木のドア
Crimson Door => JE: 真紅のドア / BE: ドア (クリムゾン)
Warped Door => JE: 歪んだドア / BE: ゆがんだドア
Dragon's Breath => JE: ドラゴンブレス / BE: ドラゴンの息
Ink Sac => JE: イカスミ / BE: 墨袋
Black Dye => JE: 黒色の染料 / BE: 黒の染料
Blue Dye => JE: 青色の染料 / BE: 青の染料
Cocoa Beans => JE: カカオ豆 / BE: ココア ビーンズ
Cyan Dye => JE: 青緑色の染料 / BE: 水色の染料
Green Dye => JE: 緑色の染料 / BE: 緑の染料
Lime Dye => JE: 黄緑色の染料 / BE: 黄緑の染料
Magenta Dye => JE: 赤紫色の染料 / BE: 赤紫の染料
Orange Dye => JE: 橙色の染料 / BE: オレンジの染料
Pink Dye => JE: 桃色の染料 / BE: ピンクの染料
Purple Dye => JE: 紫色の染料 / BE: 紫の染料
Red Dye => JE: 赤色の染料 / BE: 赤の染料
White Dye => JE: 白色の染料 / BE: 白の染料
Empty Map => JE: 白紙の地図 / BE: 空っぽの地図
Water Bottle => JE: 水入り瓶 / BE: 水のビン
Enchanted Book => JE: エンチャントの本 / BE: エンチャントした本
End Crystal => JE: エンドクリスタル / BE: 果てのクリスタル
End Rod => JE: エンドロッド / BE: 果てのロッド
Fire Charge => JE: ファイヤーチャージ / BE: 発火剤
Flight Duration: => JE: 飛翔時間： / BE: 滞空時間:
Cyan => JE: 青緑色 / BE: 水色
Pink => JE: 桃色 / BE: ピンク
Purple => JE: 紫色 / BE: 紫
Trail => JE: 流星 / BE: 光跡
Star-shaped => JE: 星型 / BE: 星形
Creeper-shaped => JE: クリーパー型 / BE: クリーパー形
Cooked Cod => JE: 焼き鱈 / BE: 焼いたタラ
Raw Cod => JE: 生鱈 / BE: 生のタラ
Cooked Salmon => JE: 焼き鮭 / BE: 調理した鮭
Fishing Rod => JE: 釣竿 / BE: 釣り竿
Flint => JE: 火打石 / BE: 火打ち石
Flint and Steel => JE: 火打石と打ち金 / BE: 火打ち石と打ち金
Glass Bottle => JE: ガラス瓶 / BE: ガラスビン
Gold Nugget => JE: 金塊 / BE: 金の塊
Diamond Helmet => JE: ダイヤモンドのヘルメット / BE: ダイヤモンドの兜
Golden Helmet => JE: 金のヘルメット / BE: 金の兜
Iron Helmet => JE: 鉄のヘルメット / BE: 鉄の兜
Diamond Hoe => JE: ダイヤモンドのクワ / BE: ダイヤモンドのくわ
Golden Hoe => JE: 金のクワ / BE: 金のくわ
Iron Hoe => JE: 鉄のクワ / BE: 鉄のくわ
Stone Hoe => JE: 石のクワ / BE: 石のくわ
Wooden Hoe => JE: 木のクワ / BE: 木のくわ
Honey Bottle => JE: ハチミツ入りの瓶 / BE: ハニーボトル
Gold Ingot => JE: 金インゴット / BE: 金の延べ棒
Iron Ingot => JE: 鉄インゴット / BE: 鉄の延べ棒
Netherite Ingot => JE: ネザライトインゴット / BE: ネザライト インゴット
Netherite Scrap => JE: ネザライトの欠片 / BE: ネザライト スクラップ
Netherite Pickaxe => JE: ネザライトのツルハシ / BE: ネザライトのつるはし
Netherite Hoe => JE: ネザライトのクワ / BE: ネザライトの鍬
Netherite Chestplate => JE: ネザライトのチェストプレート / BE: ネザライトの胸当て
Lead => JE: リード / BE: 首ひも
Leather Pants => JE: 革のズボン / BE: 革のパンツ
Diamond Leggings => JE: ダイヤモンドのレギンス / BE: ダイヤモンドの脚甲
Golden Leggings => JE: 金のレギンス / BE: 金の脚甲
Iron Leggings => JE: 鉄のレギンス / BE: 鉄の脚甲
Heart of the Sea => JE: 海洋の心 / BE: 海の中心
Mushroom Stew => JE: キノコシチュー / BE: きのこシチュー
Cooked Mutton => JE: 焼き羊肉 / BE: 調理した羊肉
Baked Potato => JE: ベイクドポテト / BE: ベイクド ポテト
Poisonous Potato => JE: 青くなったジャガイモ / BE: 有毒なジャガイモ
Prismarine Crystals => JE: プリズマリンクリスタル / BE: 海結晶
Prismarine Shard => JE: プリズマリンの欠片 / BE: 暗海晶の破片
Pumpkin Pie => JE: パンプキンパイ / BE: パンプキン パイ
Cooked Rabbit => JE: 焼き兎肉 / BE: 調理した兎肉
C418 - blocks => JE: C418 - blocks / BE: C418 - ブロック
C418 - cat => JE: C418 - cat / BE: C418 - キャット
C418 - chirp => JE: C418 - chirp / BE: C418 - チャープ
C418 - far => JE: C418 - far / BE: C418 - ファー
C418 - mall => JE: C418 - mall / BE: C418 - 散歩
C418 - mellohi => JE: C418 - mellohi / BE: C418 - メロヒー
Music Disc => JE: レコード / BE: 音楽ディスク
C418 - stal => JE: C418 - stal / BE: C418 - スタル
C418 - strad => JE: C418 - strad / BE: C418 - ストラド
C418 - wait => JE: C418 - wait / BE: C418 - ウェイト
C418 - ward => JE: C418 - ward / BE: C418 - ワード
Lena Raine - Pigstep => JE: Lena Raine - Pigstep / BE: レナ レイン - Pigstep
Redstone Dust => JE: レッドストーンダスト / BE: レッドストーンの粉
Kelp => JE: コンブ / BE: 昆布
Dried Kelp => JE: 乾燥した昆布 / BE: 乾燥昆布
Rotten Flesh => JE: 腐った肉 / BE: 腐肉
Oak Sign => JE: オークの看板 / BE: 樫の看板
Birch Sign => JE: シラカバの看板 / BE: 樺の看板
Jungle Sign => JE: ジャングルの看板 / BE: ジャングルの木の看板
Dark Oak Sign => JE: ダークオークの看板 / BE: 黒樫の看板
Crimson Sign => JE: 真紅の看板 / BE: 看板 (クリムゾン)
Warped Sign => JE: 歪んだ看板 / BE: ゆがんだ看板
Creeper Head => JE: クリーパーの頭 / BE: クリーパー ヘッド
%s's Head => JE: %sの頭 / BE: %sのヘッド
Skeleton Skull => JE: スケルトンの頭蓋骨 / BE: スケルトンの頭
Wither Skeleton Skull => JE: ウィザースケルトンの頭蓋骨 / BE: ウィザー スケルトンの頭
Unbreakable => JE: 不可壊 / BE: 耐久
Turtle Shell => JE: カメの甲羅 / BE: 亀の甲羅
Scute => JE: カメのウロコ / BE: 甲羅のかけら
Sweet Berries => JE: スイートベリー / BE: スイート ベリー
Suspicious Stew => JE: 怪しげなシチュー / BE: あやしいシチュー
Snout => JE: ブタの鼻の模様 / BE: 豚の鼻
Name: => JE: 名前： / BE: 名前
Turns into: => JE: 置換先： / BE: 次の値に変わります:
Attack/Destroy => JE: 攻撃する／壊す / BE: 攻撃する/壊す
Game Interface => JE: インターフェース / BE: ゲーム インターフェース
Open Command => JE: コマンドラインを開く / BE: コマンドを開く
Toggle Fullscreen => JE: フルスクリーンの切り替え / BE: 全画面モードの切り替え
Hotbar Slot 5 => JE: ホットバースロット5 / BE: ホットバー スロット 5
Hotbar Slot 9 => JE: ホットバースロット9 / BE: ホットバー スロット 9
Strafe Left => JE: 左 / BE: 左に平行移動
Button %1$s => JE: ボタン%1$s / BE: マウスボタン %1$s
List Players => JE: プレイヤーリストの表示 / BE: プレイヤーリスト
Strafe Right => JE: 右 / BE: 右に平行移動
Take Screenshot => JE: スクリーンショットの撮影 / BE: スクリーンショット撮影
Toggle Cinematic Camera => JE: 滑らかなカメラ動作の切り替え / BE: カメラ動作の切り替え
Highlight Players (Spectators) => JE: プレイヤーの強調表示（スペクテイター） / BE: ハイライトプレイヤー (観戦)
Use Item/Place Block => JE: アイテムの使用／ブロックの設置 / BE: アイテムを使用/ブロックを置く
Pause => JE: Pause / BE: ポーズ
F1 => JE: F1 / BE: F1 キー
F2 => JE: F2 / BE: F2 キー
F3 => JE: F3 / BE: F3 キー
F4 => JE: F4 / BE: F4 キー
F5 => JE: F5 / BE: F5 キー
F6 => JE: F6 / BE: F6 キー
F7 => JE: F7 / BE: F7 キー
F8 => JE: F8 / BE: F8 キー
F9 => JE: F9 / BE: F9 キー
F10 => JE: F10 / BE: F10 キー
F11 => JE: F11 / BE: F11 キー
F12 => JE: F12 / BE: F12 キー
F13 => JE: F13 / BE: F13 キー
Scanning for games on your local network => JE: LAN内のゲームを検索中 / BE: LAN 内のゲームを検索しています
Start LAN World => JE: LANワールドを公開 / BE: LAN 世界の開始
LAN World => JE: LANワールド / BE: LAN 世界
Scaling at 1:%s => JE: 縮尺1：%s / BE: ズーム 1:%s
Disconnect => JE: 切断 / BE: 切断する
Generating world => JE: ワールドを生成中 / BE: 世界を生成中
Building terrain => JE: 地形情報を生成中 / BE: 地形を構築中
Loading world => JE: ワールドを読み込み中 / BE: 世界を読み込み中
Options => JE: 設定 / BE: オプション
Play Demo World => JE: デモワールドで遊ぶ / BE: デモ世界で遊ぶ
Reset Demo World => JE: デモワールドをリセット / BE: デモ世界のリセット
Open to LAN => JE: LANに公開 / BE: LAN に公開
Singleplayer => JE: シングルプレイ / BE: シングルプレイヤー
%s joined the game => JE: %sがゲームに参加しました / BE: %s が世界にやってきました
%s (formerly known as %s) joined the game => JE: %s（旧名%s）がゲームに参加しました / BE: %s (旧称 %s) が世界にやってきました
%s left the game => JE: %sがゲームを退出しました / BE: %s が世界を去りました
This server recommends the use of a custom resource pack. => JE: このサーバーでは、カスタムリソースパックの利用をお勧めします。 / BE: このサーバーでは、カスタム リソース パックの利用をお勧めします。
Would you like to download and install it automagically? => JE: 自動的にダウンロードしてインストールしますか？ / BE: 自動的にダウンロードしてインストールしますか?
Smooth Lighting => JE: スムースライティング / BE: なめらかな光
Graphics => JE: グラフィックス / BE: グラフィック
Focused Height => JE: 入力時の高さ / BE: チャット時のログ表示エリア高さ
Unfocused Height => JE: 通常時の高さ / BE: 通常時のログ表示エリア高さ
Prompt on Links => JE: リンクを開く時に確認の表示 / BE: リンク時のプロンプト
Chat Settings... => JE: チャット設定… / BE: チャット設定...
Controls... => JE: 操作設定… / BE: 操作方法...
Customize World Settings => JE: カスタマイズワールド設定 / BE: カスタマイズ世界設定
Entity Shadows => JE: エンティティの影 / BE: エンティティ シャドウ
Force Unicode Font => JE: Unicodeフォントを強制する / BE: Unicode フォントの強制
Text Background Opacity => JE: 背景の不透明度 / BE: テキスト背景の不透明度
Hold => JE: 固定 / BE: ホールド
Invert Mouse => JE: マウス操作の反転 / BE: マウス反転
Language => JE: 言語設定 / BE: 言語
Jacket => JE: 上着 / BE: ジャケット
Left Pants Leg => JE: ズボンの左脚 / BE: 左のパンツの脚
Right Pants Leg => JE: ズボンの右脚 / BE: 右のパンツの脚
Multiplayer Settings... => JE: マルチプレイ設定… / BE: マルチプレイ設定...
Reduced Debug Info => JE: デバッグ情報を減らす / BE: まとめたデバッグ情報
Clouds => JE: 雲の表示 / BE: 雲
Render Distance => JE: 描画距離 / BE: 表示距離
Reset to Default => JE: 初期設定にリセット / BE: デフォルトに戻す
Saturation => JE: 満腹度回復 / BE: 飽和
Sensitivity => JE: マウス感度 / BE: 感度
%s: %s => JE: %s：%s / BE: %s: %s
Skin Customization... => JE: スキンのカスタマイズ… / BE: スキンのカスタマイズ...
Snooper Settings... => JE: 情報収集設定… / BE: 情報収集設定...
Accessibility => JE: アクセシビリティ設定 / BE: アクセシビリティ
Touchscreen Mode => JE: タッチスクリーンモード / BE: タッチスクリーン モード
Incompatible => JE: 非対応 / BE: 互換性がありません
Game Menu => JE: ゲームメニュー / BE: ゲーム メニュー
Game Paused => JE: ゲームを一時停止中 / BE: ゲームをポーズ中
Left => JE: 左手 / BE: 左移動
Right => JE: 右手 / BE: 右移動
Sneak => JE: スニーク / BE: しのび足
Absorption => JE: 衝撃吸収 / BE: 吸収
Blindness => JE: 盲目 / BE: 目つぶし
Conduit Power => JE: コンジットパワー / BE: コンジット パワー
Nausea => JE: 吐き気 / BE: 目まい
Strength => JE: 攻撃力上昇 / BE: 力
Mining Fatigue => JE: 採掘速度低下 / BE: 疲労
Haste => JE: 採掘速度上昇 / BE: 勤勉
When Applied: => JE: 効果： / BE: 効果:
No Effects => JE: 効果なし / BE: 効能なし
Fire Resistance => JE: 火炎耐性 / BE: 耐火
Instant Damage => JE: 即時ダメージ / BE: ダメージ
Potion of Harming => JE: 負傷のポーション / BE: ダメージのポーション
Instant Health => JE: 即時回復 / BE: 回復
Potion of Healing => JE: 治癒のポーション / BE: 回復のポーション
Health Boost => JE: 体力増強 / BE: HP ブースト
Invisibility => JE: 透明化 / BE: 不可視
Jump Boost => JE: 跳躍力上昇 / BE: 跳躍
Slowness => JE: 移動速度低下 / BE: 鈍化
Slow Falling => JE: 落下速度低下 / BE: 低速落下
Potion of Swiftness => JE: 俊敏のポーション / BE: スピードのポーション
Regeneration => JE: 再生能力 / BE: 再生
Potion of the Turtle Master => JE: タートルマスターのポーション / BE: 亀使いのポーション
Potion of Weakness => JE: 弱化のポーション / BE: 弱体化のポーション
Saving world => JE: ワールドを保存中 / BE: 世界を保存しています
Select Resource Packs => JE: リソースパックの選択 / BE: リソース パックの選択
Type => JE: タイプ / BE: 種類
Couldn't save screenshot: %s => JE: スクリーンショットを保存できませんでした：%s / BE: スクリーンショットを保存できませんでした: %s
Saved screenshot as %s => JE: スクリーンショットをファイル名%sとして保存しました / BE: スクリーンショットをファイル名 %s として保存しました
Minecraft Server => JE: Minecraftサーバー / BE: Minecraft サーバー
(Hidden) => JE: （非表示） / BE: (非表示)
Select Server => JE: サーバー選択 / BE: サーバーを選択
Must be converted! => JE: ワールドデータを変換する必要があります / BE: 変換する必要があります!
Create New World => JE: ワールド新規作成 / BE: 新しい世界
Play New Demo World => JE: 新しいデモワールドで遊ぶ / BE: 新しいデモ世界で遊ぶ
Are you sure you want to delete this world? => JE: このワールドを削除しますか？ / BE: 本当にこの世界を削除してもよろしいですか?
World Name => JE: ワールド名 / BE: 世界の名前
Unlimited resources, free flying and => JE: アイテムが無制限、飛行可能で、 / BE: アイテムの無制限の使用、飛行、そして
destroy blocks instantly => JE: ブロックを瞬時に破壊できる / BE: ブロックの瞬時破壊が可能です
difficulty, and one life only => JE: されていて、命はたったひとつだけ / BE: 命はひとつしかありません
Spectator => JE: スペクテイター / BE: 観戦者
You can look but don't touch => JE: 鑑賞可能、干渉不可 / BE: 見ることはできても触ることはできません
levels, health and hunger => JE: 貯める必要があり、体力、空腹の要素がある / BE: レベル、HP、空腹の要素があります
More World Options... => JE: その他のワールド設定… / BE: その他の世界設定...
Re-Create => JE: 再生成 / BE: 再度作成
Will be saved in: => JE: 保存先： / BE: 保存先:
Leave blank for a random seed => JE: 空白でランダムシード値 / BE: ランダムに種を決める場合、空白のままにしてください
Play Selected World => JE: 選択したワールドで遊ぶ / BE: 選択中の世界で遊ぶ
Select World => JE: ワールドを選択 / BE: 世界を選択
Jukebox/Note Blocks => JE: ジュークボックス／音符ブロック / BE: ジュークボックス/音符ブロック
Armor Pieces Cleaned => JE: 防具を脱色した回数 / BE: 鎧を洗浄した回数
Banners Cleaned => JE: 旗を脱色した回数 / BE: 旗を洗浄した回数
Interactions with Brewing Stand => JE: 醸造台を使用した回数 / BE: 調合台を使用した回数
Cake Slices Eaten => JE: ケーキの一切れを食べた回数 / BE: 食べたケーキ片の数
Cauldrons Filled => JE: 大釜を水で満たした回数 / BE: 大釜に水を溜めた回数
Water Taken from Cauldron => JE: 大釜から水を取った回数 / BE: 大釜から水を汲み取った回数
Chests Opened => JE: チェストを開いた回数 / BE: 開いたチェストの数
Times Crafted => JE: 作った回数 / BE: 工作した回数
Distance Crouched => JE: スニークした距離 / BE: しのび足した距離
Number of Deaths => JE: 死亡回数 / BE: 力尽きた回数
Dispensers Searched => JE: ディスペンサーの中身を見た回数 / BE: 発射装置を開いた回数
Items Dropped => JE: アイテムを捨てた回数 / BE: 落としたアイテムの数
Droppers Searched => JE: ドロッパーの中身を見た回数 / BE: ドロッパーを開いた回数
You have never been killed by %s => JE: まだ%sに倒されたことがありません / BE: まだ %s に倒されたことはありません
You have never killed %s => JE: まだ%sを倒したことがありません / BE: まだ %s を倒したことがありません
Fish Caught => JE: 魚を釣った回数 / BE: 釣った魚の数
Distance Flown => JE: 空中を移動した距離 / BE: 浮いた距離
Hoppers Searched => JE: ホッパーの中身を見た回数 / BE: ホッパーを開いた回数
Distance by Horse => JE: ウマで移動した距離 / BE: ウマに乗って移動した距離
Times Mined => JE: 採取した回数 / BE: 採掘した回数
Mob Kills => JE: Mobを倒した回数 / BE: 倒したモブの数
Mobs => JE: Mob / BE: 生き物
Distance by Pig => JE: ブタで移動した距離 / BE: 豚で移動した距離
Player Kills => JE: プレイヤーを倒した回数 / BE: 倒したプレイヤーの数
Trapped Chests Triggered => JE: トラップチェストを反応させた回数 / BE: トラップチェストを開いた回数
Times Used => JE: 使用した回数 / BE: 使った回数
Statistic => JE: 統計値 / BE: 統計
Home => JE: Home / BE: ホーム
Current => JE: 現在の設定 / BE: 現在
Disconnected => JE: 切断されました / BE: インターネット接続なし
Acacia Fence => JE: アカシアのフェンス / BE: アカシアの木の柵
Acacia Fence Gate => JE: アカシアのフェンスゲート / BE: アカシアの木の柵のゲート
Activator Rail => JE: アクティベーターレール / BE: アクティベーター レール
Primary Power => JE: 主効果 / BE: 一次パワー
Secondary Power => JE: 副効果 / BE: 二次パワー
Beehive => JE: 養蜂箱 / BE: ハチの巣箱
Bee Nest => JE: ミツバチの巣 / BE: ハチの巣
Target => JE: 的 / BE: ターゲット
This bed is occupied => JE: このベッドは既に使われています / BE: このベッドは使用中です
Respawn point set => JE: リスポーン地点が設定されました / BE: リスポーン位置の設定
Birch Fence => JE: シラカバのフェンス / BE: 樺の木の柵
Birch Fence Gate => JE: シラカバのフェンスゲート / BE: 樺の木の柵のゲート
Block of Coal => JE: 石炭ブロック / BE: 石炭のブロック
Block of Diamond => JE: ダイヤモンドブロック / BE: ダイヤモンドのブロック
Block of Emerald => JE: エメラルドブロック / BE: エメラルドのブロック
Block of Gold => JE: 金ブロック / BE: 金のブロック
Block of Iron => JE: 鉄ブロック / BE: 鉄のブロック
Block of Redstone => JE: レッドストーンブロック / BE: レッドストーンのブロック
Brown Mushroom => JE: 茶色のキノコ / BE: きのこ (茶色)
Mushroom Stem => JE: キノコの柄 / BE: きのこの柄
Brown Mushroom Block => JE: 茶色のキノコブロック / BE: きのこブロック (茶色)
Oak Button => JE: オークのボタン / BE: 樫の木のボタン
Birch Button => JE: シラカバのボタン / BE: 樺の木のボタン
Dark Oak Button => JE: ダークオークのボタン / BE: 黒樫の木のボタン
Jungle Button => JE: ジャングルのボタン / BE: ジャングルの木のボタン
Spruce Button => JE: トウヒのボタン / BE: トウヒの木のボタン
Dried Kelp Block => JE: 乾燥した昆布ブロック / BE: 乾燥昆布ブロック
Carved Pumpkin => JE: くり抜かれたカボチャ / BE: 飾りカボチャ
Jigsaw Block => JE: ジグソーブロック / BE: ジグソー ブロック
Honey Block => JE: ハチミツブロック / BE: ハチのブロック
Honeycomb Block => JE: ハニカムブロック / BE: ハニカム ブロック
Lodestone => JE: ロードストーン / BE: ロデストーン
Crimson Stem => JE: 真紅の幹 / BE: 幹 (クリムゾン)
Warped Stem => JE: 歪んだ幹 / BE: ゆがんだ幹
Stripped Crimson Stem => JE: 表皮を剥いだ真紅の幹 / BE: 皮のはがれた幹(クリムゾン)
Stripped Warped Stem => JE: 表皮を剥いだ歪んだ幹 / BE: 皮のはがれたゆがんだ幹
Crimson Hyphae => JE: 真紅の菌糸 / BE: 菌糸 (クリムゾン)
Warped Hyphae => JE: 歪んだ菌糸 / BE: ゆがんだ菌氏
Stripped Crimson Hyphae => JE: 表皮を剥いだ真紅の菌糸 / BE: 皮のはがれた菌糸 (クリムゾン)
Stripped Warped Hyphae => JE: 表皮を剥いだ歪んだ菌糸 / BE: 皮のはがれたゆがんだ菌糸
Crimson Planks => JE: 真紅の板材 / BE: 木材 (クリムゾン)
Warped Planks => JE: 歪んだ板材 / BE: ゆがんだ木材
Crimson Trapdoor => JE: 真紅のトラップドア / BE: トラップドア (クリムゾン)
Warped Trapdoor => JE: 歪んだトラップドア / BE: ゆがんだトラップドア
Crimson Stairs => JE: 真紅の階段 / BE: 階段 (クリムゾン)
Warped Stairs => JE: 歪んだ階段 / BE: ゆがんだ階段
Crimson Fence => JE: 真紅のフェンス / BE: 柵 (クリムゾン)
Warped Fence => JE: 歪んだフェンス / BE: ゆがんだ柵
Crimson Fence Gate => JE: 真紅のフェンスゲート / BE: 柵のゲート (クリムゾン)
Warped Fence Gate => JE: 歪んだフェンスゲート / BE: ゆがんだ柵のゲート
Crimson Button => JE: 真紅のボタン / BE: ボタン (クリムゾン)
Warped Button => JE: 歪んだボタン / BE: ゆがんだボタン
Crimson Pressure Plate => JE: 真紅の感圧板 / BE: 重量感知板 (クリムゾン)
Warped Pressure Plate => JE: 歪んだ感圧板 / BE: ゆがんだ重量感知板
Crimson Slab => JE: 真紅のハーフブロック / BE: ハーフブロック (クリムゾン)
Warped Slab => JE: 歪んだハーフブロック / BE: ゆがんだハーフブロック
Shroomlight => JE: シュルームライト / BE: きのこライト
Crimson Nylium => JE: 真紅のナイリウム / BE: ニリウム (クリムゾン)
Warped Nylium => JE: 歪んだナイリウム / BE: ゆがんだニリウム
Polished Blackstone Bricks => JE: 磨かれたブラックストーンレンガ / BE: 磨かれたブラックストーン レンガ
Cracked Polished Blackstone Bricks => JE: ひび割れたブラックストーンレンガ / BE: ひび割れた磨かれたブラックストーンレンガ
Polished Blackstone Brick Stairs => JE: 磨かれたブラックストーンレンガの階段 / BE: 磨かれたブラックストーン レンガの階段
Blackstone Wall => JE: ブラックストーンの塀 / BE: ブラックストーンの壁
Polished Blackstone Brick Wall => JE: 磨かれたブラックストーンレンガの塀 / BE: 磨かれたブラックストーン レンガの壁
Chiseled Polished Blackstone => JE: 模様入りの磨かれたブラックストーン / BE: 模様入り磨かれたブラックストーン
Gilded Blackstone => JE: きらめくブラックストーン / BE: 金色のブラックストーン
Polished Blackstone Brick Slab => JE: 磨かれたブラックストーンレンガのハーフブロック / BE: 磨かれたブラックストーン レンガのハーフブロック
Soul Soil => JE: ソウルソイル / BE: 魂の土壌
Soul Fire => JE: 魂の炎 / BE: 魂のファイア
Polished Blackstone Pressure Plate => JE: 磨かれたブラックストーンの感圧板 / BE: 磨かれたブラックストーンの重量感知板
Polished Blackstone Wall => JE: 磨かれたブラックストーンの塀 / BE: 磨かれたブラックストーンの壁
Soul Campfire => JE: 魂の焚き火 / BE: 魂のたき火
Chiseled Nether Bricks => JE: 模様入りのネザーレンガ / BE: 模様入りネザーレンガ
Quartz Bricks => JE: クォーツレンガ / BE: クォーツ レンガ
Trapped Chest => JE: トラップチェスト / BE: トラップ チェスト
White Shulker Box => JE: 白色のシュルカーボックス / BE: 白のシュルカー ボックス
Orange Shulker Box => JE: 橙色のシュルカーボックス / BE: オレンジのシュルカー ボックス
Magenta Shulker Box => JE: 赤紫色のシュルカーボックス / BE: 赤紫のシュルカー ボックス
Light Blue Shulker Box => JE: 空色のシュルカーボックス / BE: 空色のシュルカー ボックス
Yellow Shulker Box => JE: 黄色のシュルカーボックス / BE: 黄色のシュルカー ボックス
Lime Shulker Box => JE: 黄緑色のシュルカーボックス / BE: 黄緑のシュルカー ボックス
Pink Shulker Box => JE: 桃色のシュルカーボックス / BE: ピンクのシュルカー ボックス
Gray Shulker Box => JE: 灰色のシュルカーボックス / BE: 灰色のシュルカー ボックス
Light Gray Shulker Box => JE: 薄灰色のシュルカーボックス / BE: 薄灰色のシュルカー ボックス
Cyan Shulker Box => JE: 青緑色のシュルカーボックス / BE: 水色のシュルカー ボックス
Purple Shulker Box => JE: 紫色のシュルカーボックス / BE: 紫のシュルカー ボックス
Blue Shulker Box => JE: 青色のシュルカーボックス / BE: 青のシュルカー ボックス
Brown Shulker Box => JE: 茶色のシュルカーボックス / BE: 茶色のシュルカー ボックス
Green Shulker Box => JE: 緑色のシュルカーボックス / BE: 緑のシュルカー ボックス
Red Shulker Box => JE: 赤色のシュルカーボックス / BE: 赤のシュルカー ボックス
Black Shulker Box => JE: 黒色のシュルカーボックス / BE: 黒のシュルカー ボックス
Chorus Flower => JE: コーラスフラワー / BE: コーラスの花
Chorus Plant => JE: コーラスプラント / BE: コーラス プラント
White Stained Glass => JE: 白色の色付きガラス / BE: 白のステンドグラス
Light Gray Stained Glass => JE: 薄灰色の色付きガラス / BE: 薄灰色のステンドグラス
Gray Stained Glass => JE: 灰色の色付きガラス / BE: 灰色のステンドグラス
Black Stained Glass => JE: 黒色の色付きガラス / BE: 黒のステンドグラス
Brown Stained Glass => JE: 茶色の色付きガラス / BE: 茶色のステンドグラス
Red Stained Glass => JE: 赤色の色付きガラス / BE: 赤のステンドグラス
Orange Stained Glass => JE: 橙色の色付きガラス / BE: オレンジのステンドグラス
Yellow Stained Glass => JE: 黄色の色付きガラス / BE: 黄色のステンドグラス
Lime Stained Glass => JE: 黄緑色の色付きガラス / BE: 黄緑のステンドグラス
Green Stained Glass => JE: 緑色の色付きガラス / BE: 緑のステンドグラス
Cyan Stained Glass => JE: 青緑色の色付きガラス / BE: 水色の色付きガラス
Blue Stained Glass => JE: 青色の色付きガラス / BE: 青のステンドグラス
Purple Stained Glass => JE: 紫色の色付きガラス / BE: 紫のステンドグラス
Magenta Stained Glass => JE: 赤紫色の色付きガラス / BE: 赤紫のステンドグラス
Pink Stained Glass => JE: 桃色の色付きガラス / BE: ピンクのステンドグラス
White Stained Glass Pane => JE: 白色の色付きガラス板 / BE: 白のステンドグラス窓
Light Gray Stained Glass Pane => JE: 薄灰色の色付きガラス板 / BE: 薄灰色のステンドグラス窓
Gray Stained Glass Pane => JE: 灰色の色付きガラス板 / BE: 灰色のステンドグラス窓
Black Stained Glass Pane => JE: 黒色の色付きガラス板 / BE: 黒のステンドグラス窓
Brown Stained Glass Pane => JE: 茶色の色付きガラス板 / BE: 茶色のステンドグラス窓
Red Stained Glass Pane => JE: 赤色の色付きガラス板 / BE: 赤のステンドグラス窓
Orange Stained Glass Pane => JE: 橙色の色付きガラス板 / BE: オレンジのステンドグラス窓
Yellow Stained Glass Pane => JE: 黄色の色付きガラス板 / BE: 黄色のステンドグラス窓
Lime Stained Glass Pane => JE: 黄緑色の色付きガラス板 / BE: 黄緑のステンドグラス窓
Green Stained Glass Pane => JE: 緑色の色付きガラス板 / BE: 緑のステンドグラス窓
Cyan Stained Glass Pane => JE: 青緑色の色付きガラス板 / BE: 水色のステンドグラス窓
Blue Stained Glass Pane => JE: 青色の色付きガラス板 / BE: 青のステンドグラス窓
Purple Stained Glass Pane => JE: 紫色の色付きガラス板 / BE: 紫のステンドグラス窓
Magenta Stained Glass Pane => JE: 赤紫色の色付きガラス板 / BE: 赤紫のステンドグラス窓
Pink Stained Glass Pane => JE: 桃色の色付きガラス板 / BE: ピンクのステンドグラス窓
Black Terracotta => JE: 黒色のテラコッタ / BE: 黒のテラコッタ
Blue Terracotta => JE: 青色のテラコッタ / BE: 青のテラコッタ
Cyan Terracotta => JE: 青緑色のテラコッタ / BE: 水色のテラコッタ
Green Terracotta => JE: 緑色のテラコッタ / BE: 緑のテラコッタ
Lime Terracotta => JE: 黄緑色のテラコッタ / BE: 黄緑のテラコッタ
Magenta Terracotta => JE: 赤紫色のテラコッタ / BE: 赤紫のテラコッタ
Orange Terracotta => JE: 橙色のテラコッタ / BE: オレンジのテラコッタ
Pink Terracotta => JE: 桃色のテラコッタ / BE: ピンクのテラコッタ
Purple Terracotta => JE: 紫色のテラコッタ / BE: 紫のテラコッタ
Red Terracotta => JE: 赤色のテラコッタ / BE: 赤のテラコッタ
White Terracotta => JE: 白色のテラコッタ / BE: 白のテラコッタ
Structure Block => JE: ストラクチャーブロック / BE: ストラクチャー ブロック
Structure Void => JE: ストラクチャーヴォイド / BE: ストラクチャー ヴォイド
Black Wool => JE: 黒色の羊毛 / BE: 黒のウール
Blue Wool => JE: 青色の羊毛 / BE: 青のウール
Brown Wool => JE: 茶色の羊毛 / BE: 茶色のウール
Cyan Wool => JE: 青緑色の羊毛 / BE: 水色のウール
Gray Wool => JE: 灰色の羊毛 / BE: 灰色のウール
Green Wool => JE: 緑色の羊毛 / BE: 緑のウール
Light Blue Wool => JE: 空色の羊毛 / BE: 空色のウール
Lime Wool => JE: 黄緑色の羊毛 / BE: 黄緑のウール
Magenta Wool => JE: 赤紫色の羊毛 / BE: 赤紫のウール
Orange Wool => JE: 橙色の羊毛 / BE: オレンジのウール
Pink Wool => JE: 桃色の羊毛 / BE: ピンクのウール
Purple Wool => JE: 紫色の羊毛 / BE: 紫のウール
Red Wool => JE: 赤色の羊毛 / BE: 赤のウール
Light Gray Wool => JE: 薄灰色の羊毛 / BE: 薄灰色のウール
White Wool => JE: 白色の羊毛 / BE: 白のウール
Yellow Wool => JE: 黄色の羊毛 / BE: 黄色のウール
Mossy Cobblestone Wall => JE: 苔むした丸石の塀 / BE: 苔の生えた丸石の壁
Cobblestone Wall => JE: 丸石の塀 / BE: 丸石の壁
Granite Wall => JE: 花崗岩の塀 / BE: 花崗岩の壁
Diorite Wall => JE: 閃緑岩の塀 / BE: 閃緑岩の壁
Andesite Wall => JE: 安山岩の塀 / BE: 安山岩の壁
Sandstone Wall => JE: 砂岩の塀 / BE: 砂岩の壁
Brick Wall => JE: レンガの塀 / BE: レンガの壁
Stone Brick Wall => JE: 石レンガの塀 / BE: 石レンガの壁
Mossy Stone Brick Wall => JE: 苔むした石レンガの塀 / BE: 苔の生えた石レンガの壁
Nether Brick Wall => JE: ネザーレンガの塀 / BE: ネザーレンガの壁
End Stone Brick Wall => JE: エンドストーンレンガの塀 / BE: エンドストーンレンガの壁
Prismarine Wall => JE: プリズマリンの塀 / BE: 海晶ブロックの壁
Red Sandstone Wall => JE: 赤い砂岩の塀 / BE: 赤砂岩の壁
Red Nether Brick Wall => JE: 赤いネザーレンガの塀 / BE: 赤いネザーレンガの壁
Cocoa => JE: カカオの実 / BE: ココア
Repeating Command Block => JE: リピートコマンドブロック / BE: コマンドブロックの反復
Chain Command Block => JE: チェーンコマンドブロック / BE: コマンドブロックのチェーン
Dark Oak Fence => JE: ダークオークのフェンス / BE: 黒樫の木の柵
Dark Oak Fence Gate => JE: ダークオークのフェンスゲート / BE: 黒樫の木の柵のゲート
Detector Rail => JE: ディテクターレール / BE: 感知レール
Coarse Dirt => JE: 粗い土 / BE: 荒れた土
Purpur Block => JE: プルプァブロック / BE: プルプァ ブロック
Farmland => JE: 耕地 / BE: 農地
Oak Fence => JE: オークのフェンス / BE: 樫の木の柵
Oak Fence Gate => JE: オークのフェンスゲート / BE: 樫の木の柵のゲート
Fire => JE: 炎 / BE: 火
Crimson Roots => JE: 真紅の根 / BE: 根 (クリムゾン)
Warped Roots => JE: 歪んだ根 / BE: ゆがんだ根
Orange Tulip => JE: 橙色のチューリップ / BE: オレンジのチューリップ
Pink Tulip => JE: 桃色のチューリップ / BE: ピンクのチューリップ
Red Tulip => JE: 赤色のチューリップ / BE: 赤のチューリップ
White Tulip => JE: 白色のチューリップ / BE: 白のチューリップ
Wither Rose => JE: ウィザーローズ / BE: ウィザーのバラ
Powered Rail => JE: パワードレール / BE: 加速レール
Dirt Path => JE: 土の道 / BE: 未舗装路
Hay Bale => JE: 干草の俵 / BE: 干し草の俵
Netherrack => JE: ネザーラック / BE: ネザーレック
Blue Ice => JE: 青氷 / BE: 青の氷
Jungle Fence => JE: ジャングルのフェンス / BE: ジャングルの木の柵
Jungle Fence Gate => JE: ジャングルのフェンスゲート / BE: ジャングルの木の柵のゲート
Dark Oak Leaves => JE: ダークオークの葉 / BE: 黒樫の木の葉
Birch Leaves => JE: シラカバの葉 / BE: 樺の葉
Jungle Leaves => JE: ジャングルの葉 / BE: ジャングルの木の葉
Oak Leaves => JE: オークの葉 / BE: 樫の葉
Acacia Log => JE: アカシアの原木 / BE: アカシアの丸太
Dark Oak Log => JE: ダークオークの原木 / BE: 黒樫の丸太
Birch Log => JE: シラカバの原木 / BE: 樺の丸太
Jungle Log => JE: ジャングルの原木 / BE: ジャングルの木の丸太
Oak Log => JE: オークの原木 / BE: 樫の丸太
Spruce Log => JE: トウヒの原木 / BE: トウヒの丸太
Magma Block => JE: マグマブロック / BE: マグマ ブロック
Note Block => JE: 音符ブロック / BE: 音ブロック
Nether Brick Fence => JE: ネザーレンガのフェンス / BE: ネザーレンガの柵
Warped Wart Block => JE: 歪んだウォートブロック / BE: ゆがんだウォートブロック
Redstone Torch => JE: レッドストーントーチ / BE: レッドストーンのたいまつ
Soul Torch => JE: 魂の松明 / BE: 魂のたいまつ
Observer => JE: オブザーバー / BE: 観察者
Sticky Piston => JE: 粘着ピストン / BE: 吸着ピストン
Oak Pressure Plate => JE: オークの感圧板 / BE: 樫の木の重量感知板
Acacia Pressure Plate => JE: アカシアの感圧板 / BE: アカシアの重量感知板
Birch Pressure Plate => JE: シラカバの感圧板 / BE: 樺の木の重量感知板
Dark Oak Pressure Plate => JE: ダークオークの感圧板 / BE: 黒樫の木の重量感知板
Jungle Pressure Plate => JE: ジャングルの感圧板 / BE: ジャングルの木の重量感知板
Spruce Pressure Plate => JE: トウヒの感圧板 / BE: トウヒの木の重量感知板
Prismarine Bricks => JE: プリズマリンレンガ / BE: 海晶レンガ
Dark Prismarine => JE: ダークプリズマリン / BE: 暗海晶ブロック
Prismarine => JE: プリズマリン / BE: 海晶ブロック
Chiseled Quartz Block => JE: 模様入りのクォーツブロック / BE: 模様入りクォーツのブロック
Block of Quartz => JE: クォーツブロック / BE: クォーツのブロック
Smooth Quartz Block => JE: 滑らかなクォーツブロック / BE: なめらかなクォーツ ブロック
Red Mushroom => JE: 赤色のキノコ / BE: キノコ (赤)
Crimson Fungus => JE: 真紅のキノコ / BE: きのこ (クリムゾン)
Warped Fungus => JE: 歪んだキノコ / BE: ゆがんだきのこ
Red Mushroom Block => JE: 赤色のキノコブロック / BE: きのこブロック (赤)
Chiseled Red Sandstone => JE: 模様入りの赤い砂岩 / BE: 模様入りの赤砂岩
Red Sandstone => JE: 赤い砂岩 / BE: 赤砂岩
Smooth Red Sandstone => JE: 滑らかな赤い砂岩 / BE: 滑らかな赤砂岩
Cut Red Sandstone => JE: 研がれた赤い砂岩 / BE: カットされた赤砂岩
Redstone Lamp => JE: レッドストーンランプ / BE: レッドストーン ランプ
Red Sand => JE: 赤い砂 / BE: 赤砂
Chiseled Sandstone => JE: 模様入りの砂岩 / BE: 模様入り砂岩
Smooth Sandstone => JE: 滑らかな砂岩 / BE: なめらかな砂岩
Cut Sandstone => JE: 研がれた砂岩 / BE: カットされた砂岩
Dark Oak Sapling => JE: ダークオークの苗木 / BE: 黒樫の苗木
Birch Sapling => JE: シラカバの苗木 / BE: 樺の苗木
Oak Sapling => JE: オークの苗木 / BE: 樫の苗木
Sea Lantern => JE: シーランタン / BE: 海のランタン
Wet Sponge => JE: 濡れたスポンジ / BE: ぬれたスポンジ
Spruce Fence => JE: トウヒのフェンス / BE: トウヒの木の柵
Spruce Fence Gate => JE: トウヒのフェンスゲート / BE: トウヒの木の柵のゲート
Brick Stairs => JE: レンガの階段 / BE: レンガ階段
Smooth Quartz Stairs => JE: 滑らかなクォーツの階段 / BE: なめらかなクォーツの階段
Red Sandstone Stairs => JE: 赤い砂岩の階段 / BE: 赤砂岩の階段
Stone Brick Stairs => JE: 石レンガの階段 / BE: 石レンガ階段
Prismarine Stairs => JE: プリズマリンの階段 / BE: 海晶ブロックの階段
Dark Prismarine Stairs => JE: ダークプリズマリンの階段 / BE: 暗海晶ブロックの階段
Prismarine Brick Stairs => JE: プリズマリンレンガの階段 / BE: 海晶レンガの階段
Mossy Stone Brick Stairs => JE: 苔むした石レンガの階段 / BE: 苔の生えた石レンガの階段
Smooth Red Sandstone Stairs => JE: 滑らかな赤い砂岩の階段 / BE: なめらかな赤砂岩の階段
Smooth Sandstone Stairs => JE: 滑らかな砂岩の階段 / BE: なめらかな砂岩の階段
Mossy Cobblestone Stairs => JE: 苔むした丸石の階段 / BE: 苔の生えた丸石の階段
Smooth Stone => JE: 滑らかな石 / BE: なめらかな石
Chiseled Stone Bricks => JE: 模様入りの石レンガ / BE: 模様入り石レンガ
Mossy Stone Bricks => JE: 苔むした石レンガ / BE: 苔の生えた石レンガ
Mossy Cobblestone => JE: 苔むした丸石 / BE: 苔の生えた丸石
Cobblestone Slab => JE: 丸石のハーフブロック / BE: 丸石ハーフブロック
Stone Slab => JE: 石のハーフブロック / BE: 石ハーフブロック
Sandstone Slab => JE: 砂岩のハーフブロック / BE: 砂岩ハーフブロック
Smooth Stone Slab => JE: 滑らかな石のハーフブロック / BE: なめらかな石ハーフブロック
Red Sandstone Slab => JE: 赤い砂岩のハーフブロック / BE: 赤砂岩のハーフブロック
Prismarine Slab => JE: プリズマリンのハーフブロック / BE: 海晶ブロックのハーフブロック
Dark Prismarine Slab => JE: ダークプリズマリンのハーフブロック / BE: 暗海晶ブロックのハーフブロック
Mossy Cobblestone Slab => JE: 苔むした丸石のハーフブロック / BE: 苔の生えた丸石ハーフブロック
Smooth Sandstone Slab => JE: 滑らかな砂岩のハーフブロック / BE: なめらかな砂岩ハーフブロック
End Stone Brick Slab => JE: エンドストーンレンガのハーフブロック / BE: エンドストーンレンガ ハーフブロック
Smooth Red Sandstone Slab => JE: 滑らかな赤い砂岩のハーフブロック / BE: なめらかな赤砂岩ハーフブロック
Polished Andesite Slab => JE: 磨かれた安山岩のハーフブロック / BE: 磨かれた安山岩ハーフブロック
Andesite Slab => JE: 安山岩のハーフブロック / BE: 安山岩ハーフブロック
Diorite Slab => JE: 閃緑岩のハーフブロック / BE: 閃緑岩ハーフブロック
Polished Diorite Slab => JE: 磨かれた閃緑岩のハーフブロック / BE: 磨かれた閃緑岩ハーフブロック
Granite Slab => JE: 花崗岩のハーフブロック / BE: 花崗岩ハーフブロック
Polished Granite Slab => JE: 磨かれた花崗岩のハーフブロック / BE: 磨かれた花崗岩ハーフブロック
Mossy Stone Brick Slab => JE: 苔むした石レンガのハーフブロック / BE: 苔の生えた石レンガ ハーフブロック
Smooth Quartz Slab => JE: 滑らかなクォーツのハーフブロック / BE: なめらかなクォーツ ハーフブロック
Cut Sandstone Slab => JE: 研がれた砂岩のハーフブロック / BE: カットされた砂岩ハーフブロック
Cut Red Sandstone Slab => JE: 研がれた赤い砂岩のハーフブロック / BE: カットされた赤砂岩ハーフブロック
Tube Coral Block => JE: クダサンゴブロック / BE: クダサンゴのブロック
Brain Coral Block => JE: ノウサンゴブロック / BE: 脳サンゴのブロック
Bubble Coral Block => JE: ミズタマサンゴブロック / BE: ミズタマサンゴのブロック
Fire Coral Block => JE: ミレポラサンゴブロック / BE: アナサンゴモドキのブロック
Horn Coral Block => JE: シカツノサンゴブロック / BE: 四放サンゴのブロック
Dead Tube Coral Block => JE: 死んだクダサンゴブロック / BE: 枯れたクダサンゴのブロック
Dead Brain Coral Block => JE: 死んだノウサンゴブロック / BE: 枯れた脳サンゴのブロック
Dead Bubble Coral Block => JE: 死んだミズタマサンゴブロック / BE: 枯れたミズタマサンゴのブロック
Dead Fire Coral Block => JE: 死んだミレポラサンゴブロック / BE: 枯れたアナサンゴモドキのブロック
Dead Horn Coral Block => JE: 死んだシカツノサンゴブロック / BE: 枯れた四放サンゴのブロック
Sea Pickle => JE: シーピクルス / BE: ナマコ
Brain Coral => JE: ノウサンゴ / BE: 脳サンゴ
Fire Coral => JE: ミレポラサンゴ / BE: アナサンゴモドキ
Horn Coral => JE: シカツノサンゴ / BE: 四放サンゴ
Dead Tube Coral => JE: 死んだクダサンゴ / BE: 枯れたクダサンゴ
Dead Brain Coral => JE: 死んだノウサンゴ / BE: 枯れた脳サンゴ
Dead Bubble Coral => JE: 死んだミズタマサンゴ / BE: 枯れたミズタマサンゴ
Dead Fire Coral => JE: 死んだミレポラサンゴ / BE: 枯れたアナサンゴモドキ
Dead Horn Coral => JE: 死んだシカツノサンゴ / BE: 枯れた四放サンゴ
Tube Coral Fan => JE: クダウチワサンゴ / BE: 軟質クダサンゴ
Brain Coral Fan => JE: ノウウチワサンゴ / BE: 軟質脳サンゴ
Bubble Coral Fan => JE: ミズタマウチワサンゴ / BE: 軟質ミズタマサンゴ
Fire Coral Fan => JE: ミレポラウチワサンゴ / BE: 軟質アナサンゴモドキ
Horn Coral Fan => JE: シカツノウチワサンゴ / BE: 軟質四放サンゴ
Dead Tube Coral Fan => JE: 死んだクダウチワサンゴ / BE: 枯れた軟質クダサンゴ
Dead Brain Coral Fan => JE: 死んだノウウチワサンゴ / BE: 枯れた軟質脳サンゴ
Dead Bubble Coral Fan => JE: 死んだミズタマウチワサンゴ / BE: 枯れた軟質ミズタマサンゴ
Dead Fire Coral Fan => JE: 死んだミレポラウチワサンゴ / BE: 枯れた軟質アナサンゴモドキ
Dead Horn Coral Fan => JE: 死んだシカツノウチワサンゴ / BE: 枯れた軟質四放サンゴ
TNT => JE: TNT / BE: TNT 火薬
Torch => JE: 松明 / BE: たいまつ
Oak Trapdoor => JE: オークのトラップドア / BE: 樫の木のトラップドア
Birch Trapdoor => JE: シラカバのトラップドア / BE: 樺の木のトラップドア
Dark Oak Trapdoor => JE: ダークオークのトラップドア / BE: 黒樫の木のトラップドア
Jungle Trapdoor => JE: ジャングルのトラップドア / BE: ジャングルの木のトラップドア
Spruce Trapdoor => JE: トウヒのトラップドア / BE: トウヒの木のトラップドア
Tripwire Hook => JE: トリップワイヤーフック / BE: トリップワイヤー フック
Vines => JE: ツタ / BE: つた
Weeping Vines => JE: しだれツタ / BE: ウィーピングつた
Twisting Vines => JE: ねじれツタ / BE: ねじれたつた
Black Carpet => JE: 黒色のカーペット / BE: 黒のカーペット
Blue Carpet => JE: 青色のカーペット / BE: 青のカーペット
Cyan Carpet => JE: 青緑色のカーペット / BE: 水色のカーペット
Green Carpet => JE: 緑色のカーペット / BE: 緑のカーペット
Lime Carpet => JE: 黄緑色のカーペット / BE: 黄緑のカーペット
Magenta Carpet => JE: 赤紫色のカーペット / BE: 赤紫のカーペット
Orange Carpet => JE: 橙色のカーペット / BE: オレンジのカーペット
Pink Carpet => JE: 桃色のカーペット / BE: ピンクのカーペット
Purple Carpet => JE: 紫色のカーペット / BE: 紫のカーペット
Red Carpet => JE: 赤色のカーペット / BE: 赤のカーペット
White Carpet => JE: 白色のカーペット / BE: 白のカーペット
White Glazed Terracotta => JE: 白色の彩釉テラコッタ / BE: 白の彩釉テラコッタ
Orange Glazed Terracotta => JE: 橙色の彩釉テラコッタ / BE: オレンジの彩釉テラコッタ
Magenta Glazed Terracotta => JE: 赤紫色の彩釉テラコッタ / BE: 赤紫の彩釉テラコッタ
Lime Glazed Terracotta => JE: 黄緑色の彩釉テラコッタ / BE: 黄緑の彩釉テラコッタ
Pink Glazed Terracotta => JE: 桃色の彩釉テラコッタ / BE: ピンクの彩釉テラコッタ
Cyan Glazed Terracotta => JE: 青緑色の彩釉テラコッタ / BE: 水色の彩釉テラコッタ
Purple Glazed Terracotta => JE: 紫色の彩釉テラコッタ / BE: 紫の彩釉テラコッタ
Blue Glazed Terracotta => JE: 青色の彩釉テラコッタ / BE: 青の彩釉テラコッタ
Green Glazed Terracotta => JE: 緑色の彩釉テラコッタ / BE: 緑の彩釉テラコッタ
Red Glazed Terracotta => JE: 赤色の彩釉テラコッタ / BE: 赤の彩釉テラコッタ
Black Glazed Terracotta => JE: 黒色の彩釉テラコッタ / BE: 黒の彩釉テラコッタ
Black Concrete => JE: 黒色のコンクリート / BE: 黒のコンクリート
Red Concrete => JE: 赤色のコンクリート / BE: 赤のコンクリート
Green Concrete => JE: 緑色のコンクリート / BE: 緑のコンクリート
Blue Concrete => JE: 青色のコンクリート / BE: 青のコンクリート
Purple Concrete => JE: 紫色のコンクリート / BE: 紫のコンクリート
Cyan Concrete => JE: 青緑色のコンクリート / BE: 水色のコンクリート
Pink Concrete => JE: 桃色のコンクリート / BE: ピンクのコンクリート
Lime Concrete => JE: 黄緑色のコンクリート / BE: 黄緑のコンクリート
Magenta Concrete => JE: 赤紫色のコンクリート / BE: 赤紫のコンクリート
Orange Concrete => JE: 橙色のコンクリート / BE: オレンジのコンクリート
White Concrete => JE: 白色のコンクリート / BE: 白のコンクリート
Black Concrete Powder => JE: 黒色のコンクリートパウダー / BE: 黒のコンクリート パウダー
Red Concrete Powder => JE: 赤色のコンクリートパウダー / BE: 赤のコンクリート パウダー
Green Concrete Powder => JE: 緑色のコンクリートパウダー / BE: 緑のコンクリート パウダー
Brown Concrete Powder => JE: 茶色のコンクリートパウダー / BE: 茶色のコンクリート パウダー
Blue Concrete Powder => JE: 青色のコンクリートパウダー / BE: 青のコンクリート パウダー
Purple Concrete Powder => JE: 紫色のコンクリートパウダー / BE: 紫のコンクリート パウダー
Cyan Concrete Powder => JE: 青緑色のコンクリートパウダー / BE: 水色のコンクリート パウダー
Light Gray Concrete Powder => JE: 薄灰色のコンクリートパウダー / BE: 薄灰色のコンクリート パウダー
Gray Concrete Powder => JE: 灰色のコンクリートパウダー / BE: 灰色のコンクリート パウダー
Pink Concrete Powder => JE: 桃色のコンクリートパウダー / BE: ピンクのコンクリート パウダー
Lime Concrete Powder => JE: 黄緑色のコンクリートパウダー / BE: 黄緑のコンクリート パウダー
Yellow Concrete Powder => JE: 黄色のコンクリートパウダー / BE: 黄色のコンクリート パウダー
Light Blue Concrete Powder => JE: 空色のコンクリートパウダー / BE: 空色のコンクリート パウダー
Magenta Concrete Powder => JE: 赤紫色のコンクリートパウダー / BE: 赤紫のコンクリート パウダー
Orange Concrete Powder => JE: 橙色のコンクリートパウダー / BE: オレンジのコンクリート パウダー
White Concrete Powder => JE: 白色のコンクリートパウダー / BE: 白のコンクリート パウダー
Stripped Spruce Log => JE: 樹皮を剥いだトウヒの原木 / BE: 皮のはがれたトウヒの丸太
Stripped Dark Oak Log => JE: 樹皮を剥いだダークオークの原木 / BE: 皮のはがれた黒樫の丸太
Stripped Birch Log => JE: 樹皮を剥いだシラカバの原木 / BE: 皮のはがれた樺の丸太
Stripped Jungle Log => JE: 樹皮を剥いだジャングルの原木 / BE: 皮のはがれたジャングルの丸太
Stripped Oak Log => JE: 樹皮を剥いだオークの原木 / BE: 皮のはがれた樫の丸太
Stripped Acacia Log => JE: 樹皮を剥いだアカシアの原木 / BE: 皮のはがれたアカシアの丸太
Grindstone => JE: 砥石 / BE: 石臼
Campfire => JE: 焚き火 / BE: たき火
Sweet Berry Bush => JE: スイートベリーの低木 / BE: スイート ベリーの茂み
Oak Wood => JE: オークの木 / BE: 樫の木
Birch Wood => JE: シラカバの木 / BE: 樺の木
Acacia Wood => JE: アカシアの木 / BE: アカシアの原木
Dark Oak Wood => JE: ダークオークの木 / BE: 黒樫の木
Stripped Oak Wood => JE: 樹皮を剥いだオークの木 / BE: 皮のはがれた樫の木
Stripped Spruce Wood => JE: 樹皮を剥いだトウヒの木 / BE: 皮のはがれたトウヒの木
Stripped Birch Wood => JE: 樹皮を剥いだシラカバの木 / BE: 皮のはがれた樺の木
Stripped Jungle Wood => JE: 樹皮を剥いだジャングルの木 / BE: 皮のはがれたジャングルの木
Stripped Acacia Wood => JE: 樹皮を剥いだアカシアの木 / BE: 皮のはがれたアカシアの原木
Stripped Dark Oak Wood => JE: 樹皮を剥いだダークオークの木 / BE: 皮のはがれた黒樫の木
Block of Netherite => JE: ネザライトブロック / BE: ネザライトのブロック
Ancient Debris => JE: 古代の残骸 / BE: 古代のがれき
Nether Gold Ore => JE: ネザー金鉱石 / BE: ネザーゴールド鉱石
Respawn Anchor => JE: リスポーンアンカー / BE: リスポーン アンカー
Arrow of Invisibility => JE: 透明化の矢 / BE: 不可視の矢
Arrow of Swiftness => JE: 俊敏の矢 / BE: スピードの矢
Arrow of Splashing => JE: 水の矢 / BE: 飛び散る矢
Arrow of Healing => JE: 治癒の矢 / BE: 回復の矢
Arrow of Harming => JE: 負傷の矢 / BE: ダメージの矢
Arrow of Weakness => JE: 弱化の矢 / BE: 弱体化の矢
Arrow of the Turtle Master => JE: タートルマスターの矢 / BE: 亀使いの矢
Structure Name => JE: ストラクチャー名 / BE: 構造体の名前
Show Bounding Box: => JE: 境界線を表示する： / BE: 構造体の境界線を表示:
Old graphics card detected; this may prevent you from => JE: 古いビデオカードが検出されました。将来的にOpenGL 3.2 / BE: 古いビデオカードが検出されました。これにより以下のことが拒否された可能性があります:
Prefix, %s%2$s again %s and %1$s lastly %s and also %1$s again! => JE: Prefix, %s%2$s again %s and %1$s lastly %s and also %1$s again! / BE: プレフィックス、再度 %s%2$s、%s、%1$s 最後に %s および再度 %1$s!
hi % => JE: hi % / BE: こんにちは %
hi %  s => JE: hi %s / BE: こんにちは %  s
Hello, world! => JE: Hello, world! / BE: こんにちは、世界!
world => JE: world / BE: 世界
Server Resource Packs => JE: サーバーリソースパック / BE: サーバー リソース パック
Prompt => JE: 毎回確認 / BE: プロンプト
Novice => JE: 新米 / BE: 未熟者
Journeyman => JE: 一人前 / BE: 熟練者
Expert => JE: 熟練者 / BE: 専門家
Proceed => JE: 続ける / BE: 続行
Glow Squid => JE: ヒカリイカ / BE: 発光するイカ
Copper Ingot => JE: 銅インゴット / BE: 銅の延べ棒
Powder Snow Bucket => JE: 粉雪入りバケツ / BE: 粉雪バケツ
%1$s froze to death => JE: %1$s は凍え死んだ / BE: %1$s は凍えて力尽きた
Pointed Dripstone => JE: 鍾乳石 / BE: 尖ったドリップストーン
Sculk Sensor => JE: スカルクセンサー / BE: スカルク センサー
Azalea Leaves => JE: ツツジの葉 / BE: 
Rooted Dirt => JE: 根付いた土 / BE: 
Hanging Roots => JE: 垂れ根 / BE: 
Moss Block => JE: 苔ブロック / BE: 
Moss Carpet => JE: 苔のカーペット / BE: 
Big Dripleaf => JE: 大きなドリップリーフ / BE: 
Small Dripleaf => JE: 小さなドリップリーフ / BE: 
Spore Blossom => JE: 胞子の花 / BE: 
Glow Berries => JE: グロウベリー / BE: 
%1$s was skewered by a falling stalactite => JE: %1$sは落ちてきた鍾乳石に串刺しにされた / BE: %1$s は落下する鍾乳石に串刺しにされた
Azalea => JE: ツツジ / BE: 
Flowering Azalea => JE: 開花したツツジ / BE: 
%1$s was impaled on a stalagmite => JE: %1$sは石筍の上に突き刺さった / BE: %1$s は石筍に突き刺された
Block of Copper => JE: 銅ブロック / BE: 銅のブロック
Cave Vines => JE: 洞窟のツタ / BE: 
Exposed Copper => JE: 風化した銅 / BE: 露出した銅
Weathered Copper => JE: 錆びた銅 / BE: 風化した銅
Waxed Exposed Copper => JE: 蝋引き済みの風化した銅 / BE: 磨いた露出した銅
Waxed Weathered Copper => JE: 蝋引き済みの錆びた銅 / BE: 磨いた風化した銅
Exposed Cut Copper => JE: 風化した彫金銅 / BE: 露出した切り込み入りの銅
Weathered Cut Copper => JE: 錆びた切り込み入りの銅 / BE: 風化した切り込み入りの銅
Oxidized Cut Copper => JE: 酸化した彫金銅 / BE: 酸化した切り込み入りの銅
Waxed Cut Copper => JE: 錆止めされた切り込み入りの銅 / BE: 磨いた切り込み入りの銅
Waxed Exposed Cut Copper => JE: 蝋引き済みの風化した彫金銅 / BE: 磨いた露出した切り込み入りの銅
Waxed Weathered Cut Copper => JE: 蝋引き済みの錆びた彫金銅 / BE: 磨いた風化した切り込み入りの銅
Cut Copper Stairs => JE: 切り込み入りの銅の階段 / BE: 切り込み入りの銅階段
Exposed Cut Copper Stairs => JE: 風化した切り込み入りの銅の階段 / BE: 露出した切り込み入りの銅階段
Weathered Cut Copper Stairs => JE: 錆びた切り込み入りの銅の階段 / BE: 風化した切り込み入りの銅階段
Oxidized Cut Copper Stairs => JE: 酸化した彫金銅の階段 / BE: 酸化した切り込み入りの銅階段
Waxed Cut Copper Stairs => JE: 錆止めされた切り込み入りの銅の階段 / BE: 磨いた切り込み入りの銅階段
Waxed Exposed Cut Copper Stairs => JE: 錆止めされた風化した切り込み入りの銅の階段 / BE: 磨いた露出した切り込み入りの銅階段
Waxed Weathered Cut Copper Stairs => JE: 錆止めされた錆びた切り込み入りの銅の階段 / BE: 磨いた風化した切り込み入りの銅階段
Cut Copper Slab => JE: 切り込み入りの銅のハーフブロック / BE: 切り込み入りの銅ハーフブロック
Exposed Cut Copper Slab => JE: 風化した切り込み入りの銅のハーフブロック / BE: 露出した切り込み入りの銅ハーフブロック
Weathered Cut Copper Slab => JE: 錆びた切り込み入りの銅のハーフブロック / BE: 風化した切り込み入りの銅ハーフブロック
Oxidized Cut Copper Slab => JE: 酸化した彫金銅のハーフブロック / BE: 酸化した銅ハーフブロック
Waxed Cut Copper Slab => JE: 錆止めされた切り込み入りの銅のハーフブロック / BE: 磨いた切り込み入りの銅ハーフブロック
Waxed Exposed Cut Copper Slab => JE: 錆止めされた風化した切り込み入りの銅のハーフブロック / BE: 磨いた露出した切り込み入りの銅ハーフブロック
Waxed Weathered Cut Copper Slab => JE: 錆止めされた錆びた切り込み入りの銅のハーフブロック / BE: 磨いた風化した切り込み入りの銅ハーフブロック
Glow Ink Sac => JE: 輝くイカスミ / BE: 発光する墨袋
Glow Item Frame => JE: 輝く額縁 / BE: 発光する額縁
Glow Lichen => JE: ヒカリゴケ / BE: 
